JiaweiHan	DengCai	1
IllhoiYoo	Il-YeolSong	1
SubarnaSadhukhan	S.Muthukrishnan	1
SeanCox	DanielR.Jeske	1
TakahiroKosaka	MasatoKitajima	1
Sang-ChanPark	ChongUnPyon	1
WanliZuo	ShaobinHuang	1
HarriValpola	AlexanderIlin	1
YimingYang	Hua-JunZeng	1
RuggeroG.Pensa	C*lineRobardet	1
NirmalieWiratunga	IvanKoychev	1
LucianoA.Digiampietri	Jos*deJes*sP*rezAlc*zar	1
YasunoriIshihara	ToruFujiwara	1
WagnerMeiraJr.	BerthierA.Ribeiro-Neto	1
JianhuaLu	HongjunLu	1
RuiKimura	MizuhoIwaihara	1
ElizabethJ.O'Neil	AmersonLin	1
DanielC.Zilio	AlbertoLerner	1
YingHu	JagannathanSrinivasan	1
YanzanZhou	XinJin	1
SylvainL*tourneau	ChunshengYang	1
LyleH.Ungar	DeanP.Foster	1
ZhengChen	YingChen	1
SomakRaychaudhury	LouisaNolan	1
CarloCurino	BruceLambert	1
ManoranjanDash	Liang-TienChia	1
JoostN.Kok	ElenaV.Samsonova	1
ShashiShekhar	JaideepSrivastava	1
MasateruHarao	KouichiHirata	1
RaghunathOthayothNambiar	MeikelPoess	1
PaulKomarek	AndrewW.Moore	1
ZhengjieZhang	AoyingZhou	1
ZunpingCheng	JiankuiGuo	1
RaffaellaRinaldi	ClaudioGiuliano	1
VictorVianu	MichaelA.Harrison	1
RolfLak*mper	EamonnJ.Keogh	2
VanjaJosifovski	BertVanderLinden	1
OliverSeeliger	EugeneKogan	1
RaviMurthy	EricSedlar	1
NectariaTryfona	DieterPfoser	1
SteffenBickel	PeterSiemen	1
XiaofangZhou	QinyingXu	1
TuongC.Truong	ChunZhang	1
RobertaCochrane	GeorgeLapis	1
TheodoreJohnson	S.Muthukrishnan	2
S.Muthukrishnan	RajeevRastogi	1
JavedA.Aslam	EmineYilmaz	1
ZhimingDing	MarkusSpiekermann	1
PhilipA.Bernstein	ElisaBertino	1
JishengLiang	GiovanniB.Marchisio	1
WeiHan	InderpalNarang	3
TetsuyaIshie	MasaruUeda	1
QinyingXu	JiyuanAn	1
MichaelK.Ng	LipingJing	1
KaoruKatayama	ErwanLoisant	1
WeiDai	RohiniK.Srihari	1
YunhuaHu	JunXu	1
WeiningQian	LinhaoXu	1
KevinChen-ChuanChang	HwanjoYu	1
T.S.Jayram	DouglasBurdick	1
Sa*daMedjdoub	B*atriceFinance	1
ToshiakiOkawara	ShigeoSugimoto	1
Pang-NingTan	JianzhongLi	1
PeerKr*ger	ElkeAchtert	1
WalidG.Aref	IbrahimKamel	1
FernandoA.DasNeves	EdwardA.Fox	1
MelanieHilario	EltonRexhepaj	1
DimitriTheodoratos	AntonisKoufopoulos	1
SergeAbiteboul	MosheY.Vardi	1
ShotaroMatsumoto	ManabuOkumura	1
JimKleewein	ChunZhang	1
KentaroWakatsuki	KazutoYamazaki	1
SlobodanRasetic	JamesElding	1
RicardoCartaxoModestodeSouza	MariaIsabelSobralEscada	1
TakeshiFukuda	TakahideNogayama	1
JimengSun	DeepayanChakrabarti	2
HenryF.Korth	BrianRandell	1
PhilipK.Chan	MatthewV.Mahoney	1
MichaelStonebraker	AdamBatkin	1
NarenRamakrishnan	MohammedJaveedZaki	1
JihadBoulos	ChristopherR*	1
HidehikoIno	AtsuyoshiNakamura	1
YuriBreitbart	LourensVeen	1
HaifengShen	GangLiu	1
MatthiasBender	ChristianZimmer	1
JormaBoberg	AleksandrMyll*ri	1
FlorentMasseglia	FatmaBouali	1
TatsuoTsuji	TakeshiHorie	1
ShotaroMatsumoto	HiroyaTakamura	1
WenfeiFan	MichaelFlaster	2
XiaodongZhou	RaymondT.Ng	1
Marie-ChristineRousset	KouzouOhara	1
ShariqRizvi	NathanBurkhart	1
YongtaiZhu	JiaweiHan	1
VanithaVaradarajan	AlexanderKramnik	1
NaveenAshish	AlonY.Halevy	1
ErnestoDamiani	CristianoFugazza	1
RenatoFerreira	MatheusRibeiro	1
VebjornLjosa	ChristosFaloutsos	1
LawrenceO.Hall	DmitryB.Goldgof	1
JohnJannotti	AlexanderZgolinski	1
RicardoVilalta	AbrahamBagherjeiran	1
WolfgangLindner	SamuelMadden	1
MakotoTakaki	HajimeKitakami	1
RyanShipley	JarekGryz	1
QiangYang	BenyuZhang	1
LingLi	AmritPratap	1
KrithiRamamritham	GerhardWeikum	1
ToshikazuKato	SineenardPinyapong	1
XiaolingWang	BarbaraCatania	1
BrianRandell	AlexanderB.Romanovsky	1
SugatoBasu	ChaseKrumpelman	1
TakehisaYairi	RyoheiFujimaki	2
LeefengChien	JunYan	1
HweeHwaPang	DhruvMangla	1
HongxingHe	GrahamJ.Williams	1
ChrisH.Q.Ding	AndyM.Yip	1
JianzhongLi	HongjunLu	1
ViktorGyenes	Andr*sL*rincz	1
Shi-WeiTang	MingZhang	1
VivekR.Narasayya	ArunprasadP.Marathe	1
KarstenDraba	ChristophB*hm	1
WolfgangM*ller0002	AndreasHenrich	1
DanielJ.Abadi	AdamBatkin	1
JimKleewein	GeorgeLapis	1
NikoBeerenwinkel	J*rgenK.Rockstroh	1
Tze-YunLeong	LimsoonWong	1
TsuyoshiId*	TakeshiFukuda	1
TakeshiYamada	MasakiyoFujimoto	1
RobertMcCann	HoaNguyen	1
DenisChurin	BrandonBerg	1
RaviKumar	RamanathanV.Guha	2
YutakaKatsuyama	HaruoYokota	1
Lu*sRodrigues	KrithiRamamritham	1
DiegoCalvanese	DanielaBerardi	1
MikhailBilenko	MehranSahami	1
ThomasA.Russ	EwaDeelman	1
SivasankaranChandrasekar	NipunAgarwal	1
RussellL.FinleyJr.	JingkaiYu	1
SaraJ.Graves	RahulRamachandran	1
PatrickE.O'Neil	MitchCherniack	1
TedYounglove	RuiXiao	1
SrinathShankar	AmeetKini	1
SathyakamaSandilya	R.BharatRao	2
ElkeA.Rundensteiner	BradleyMomberger	1
RongJin	LuoSi	1
Tie-YanLiu	Hua-JunZeng	1
RaviMurthy	NipunAgarwal	1
Yi-fangBrookWu	RazvanStefanBot	2
HamidPirahesh	DonaldD.Chamberlin	1
Wei-YingMa	NaiyaoZhang	1
Ya-HuiChang	Sue-ShainWu	1
VincentOria	MartaRukoz	1
ZhenHuaLiu	DanielaFlorescu	1
EugeneKogan	AdrianBaras	1
TsutomuTerada	ShojiroNishio	1
MarkoJunkkari	JaanaKek*l*inen	1
JessicaLin	AdaWai-CheeFu	1
VishalChowdhary	HimanshuGupta	1
PeterSiemen	DavidS.Vogel	1
WeiZhang	TokWangLing	1
PhilipS.Yu	ChaoLiu0001	1
NingShang	BeijunRuan	1
TaoLi	ShengMa	2
ShankarPal	EugeneKogan	1
MehrdadJahangiri	CyrusShahabi	2
NorihideKitaoka	AkiraSasou	1
ZhengChen	DongZhuang	1
JianjunHu	ChuanLi	1
Jens-PeterDittrich	AlexanderKreutz	1
TedYounglove	DouglasHolt	1
NicolaH*nle	MatthiasGro*mann	1
NematollaahShiri	MihailHalachev	1
PhilipS.Yu	MichailVlachos	4
MichaelSteinbach	HuiXiong	1
StevenGreco	Juan-CarlosJusem	1
PatrickE.O'Neil	DanielJ.Abadi	1
KevinS.Beyer	Fatma*zcan	3
TonyMullen	NigelCollier	1
SubarnaSadhukhan	ShinjiroSueda	1
PhilippePucheral	Fran*oisDangNgoc	1
ThomasEiter	GiovambattistaIanni	1
ZhiyongPeng	YuweiPeng	1
PetraPovalej	PeterKokol	1
RakeshAgrawal	KrishnaKummamuru	1
Mong-LiLee	ChenyiXia	1
ZhiqiangZhang	HangGuo	1
WeiWang0010	GuodongLiu	1
NimitKumar	DeepaParanjpe	1
MiguelFerreira	EdmondLau	1
NimitKumar	KrishnaKummamuru	1
SaraCohen	BennyKimelfeld	1
TerenceHo	RachelPottinger	1
TyroneGrandison	RakeshAgrawal	1
VivekR.Narasayya	SanjayAgrawal	1
YufeiTao	WangKayNgai	1
GerdHeber	AlexanderS.Szalay	1
XiangLi	BilahariAkkiraju	1
LeoYungHangLau	Chotirat(Ann)Ratanamahatana	1
YasushiOgawa	TetsuyaIkeda	1
GeorgGottlob	EdytaKalka	1
WynneHsu	QingZhang	1
FrankRehm	FrankKlawonn	1
PhilipA.Bernstein	Kyu-YoungWhang	2
NikoBeerenwinkel	Carlo-FedericoPerno	1
YueZhao	JoshuaZhexueHuang	1
S*rgioLifschitz	MairaFerreiradeNoronha	1
WeiFan	KaiMingTing	1
YangyongZhu	Xu-binDeng	1
TakayukiTamura	MasaruKitsuregawa	1
PrakashLinga	AdinaCrainiceanu	1
ZhengChen	WenyinLiu	1
MauricevanKeulen	JensTeubner	1
CarticRamakrishnan	AmitP.Sheth	1
SudhirVerma	JayantKalagnanam	1
NitinKumar	EamonnJ.Keogh	1
RomanSchmidt	ManfredHauswirth	1
JayavelShanmugasundaram	EugeneJ.Shekita	1
YongZhao	JamesE.Dobson	1
TakaoMiura	IsamuShioya	1
ShiyongLu	MustafaAtay	1
XinDong	AlonY.Halevy	1
KatsumiTanaka	AkihiroKuwabara	1
VanTrangNguyen	JeongHeeHwang	1
Van-NamHuynh	AkiraShimazu	1
WalidG.Aref	JeffreyScottVitter	1
WeiZhao	NanZhang0004	3
W.BruceCroft	JiwoonJeon	1
TuBaoHo	KenjiSatou	1
SathyakamaSandilya	JinboBi	1
XindongWu	GongChen	1
VladislavShkapenyuk	TheodoreJohnson	1
HeikkiMannila	GautamDas	1
AnHaiDoan	AlexanderKramnik	1
GaneshRamakrishnan	ByronDom	1
ThomasKamps	LiboChen	1
SouripriyaDas	JagannathanSrinivasan	1
IrinaRish	AlinaBeygelzimer	1
Hua-GangLi	DivyakantAgrawal	1
MaytalSaar-Tsechansky	BiancaZadrozny	1
RazvanStefanBot	QuanzhiLi	2
RobertH.Deng	ElisaBertino	1
KevinChen-ChuanChang	BinHe	4
SabineMassmann	ErhardRahm	1
YuweiPeng	BoxuanZhai	1
SasoDzeroski	HendrikBlockeel	1
MassimoMecella	DiegoCalvanese	1
TakashiBaba	KanameAmano	1
PingYu	LiqinZhang	1
NicoleSchneider	JostEnderle	1
SrinivasanParthasarathy	AnthonyD.Nguyen	1
JinyanLi	GuozhuDong	1
MichaelJ.Franklin	DavidMaier	1
JohnKomoroske	HenryG.Goldberg	1
RuiWang0002	MohamedF.Mokbel	1
ThomasB*ck	ElenaV.Samsonova	1
PatrickPantel	DunjaMladenic	1
RaviRajwar	Marie-ClaudeGaudel	1
Min-JaeLee	Kyu-YoungWhang	2
MichaelRys	GideonSchaller	1
PierangelaSamarati	CristianoFugazza	1
SunilMovva	Juan-CarlosJusem	1
NathanFolkert	AbhinavGupta	1
RakeshAgrawal	DilysThomas	1
HamidPirahesh	ChunZhang	1
HuahaiYang	H.V.Jagadish	1
KlausKorn	Carlo-FedericoPerno	1
MarioA.Nascimento	ChristianDigout	1
VipinGupta	KaranVahi	1
YasuhikoFujisaki	AkiKobayashi	1
AriD.Brooks	AnnPrestrud	1
Wei-YingMa	BinGao	1
R.BharatRao	JinboBi	2
NanWang	HuaLu	1
JianyongWang	JianLiu	1
Wei-YingMa	LieLu	1
Kun-LungWu	BugraGedik	1
MosheY.Vardi	JeffreyD.Ullman	1
GeorgeTsatsaronis	DimitriosMavroeidis	1
NicolaLeone	GiorgioTerracina	1
MichaelJ.Carey	DavidJ.DeWitt	1
TakahideNogayama	RyoHirade	1
GeorgP*lzlbauer	AndreasRauber	1
RichardKuntschke	BernhardStegmaier	1
WolfgangLehner	SebastianSch*r	1
NikoBeerenwinkel	HaukeWalter	1
WolfgangLindner	DanielJ.Abadi	1
MichelScholl	C*dricduMouza	1
VishalSikka	DeniseDraper	1
MarikoHatakeyama	AkihikoKonagaya	1
RuiYang	AnthonyK.H.Tung	1
ShishirAgrawal	NingZhang0002	1
TakuyaUkon	TakeshiHorie	1
NataliaIvanova	KrishnaPalaniappan	1
KojiIwanuma	HidetomoNabeshima	1
LiyingSui	DayouZhou	1
RafaelAlonso	HuaLi	1
TakanobuNishiura	MasakiyoFujimoto	1
YingZhang	HongyeSu	1
RaymondChi-WingWong	AdaWai-CheeFu	2
SanjayChawla	LiorLukov	1
B*lintG*bor	Andr*sL*rincz	1
VipinGupta	MarcSpraragen	1
YongZhao	IanT.Foster	1
OlgaPapaemmanouil	NesimeTatbul	1
SarunasGirdzijauskas	KarlAberer	1
SrinathShankar	JeffreyF.Naughton	1
VipinGupta	HansChalupsky	1
JulianaFreire	JayantR.Haritsa	1
RobertC.James	J*rgDenzinger	1
PengWang	BaileShi	1
Ricardo*anculef	H*ctorAllende	1
Marie-ClaudeGaudel	CliffB.Jones	1
NicolaLeone	MichaelFink	1
PhilipMaechling	KaranVahi	1
TedYounglove	DanielR.Jeske	1
RobPowers	Mois*sGoldszmidt	1
ShantanuJoshi	ChrisJermaine	2
RobertMann	RobertHutchison	1
YuriBreitbart	TorstenGrabs	1
MauricioA.Hern*ndez	HowardHo	1
Hans-PeterKriegel	ElkeAchtert	1
SungminJoo	MotomichiToyama	1
OlgaPapaemmanouil	AnjaliJhingran	1
HuanmeiWu	DavidR.Kaeli	1
YunChi	HaixunWang	2
SudiptoGuha	BoulosHarb	1
GiuseppeDeGiacomo	DanielaBerardi	1
XiaohuaZhou	IsaacChankai	1
YangyongZhu	NingShang	1
Wing-KaiHon	ElisaBertino	1
SatoshiNakamura	KazumasaYamamoto	1
PeterSiemen	PeterHaider	1
GokceLaleci	AsumanDogac	1
VishalS.Batra	K.Sel*ukCandan	1
MichaelStonebraker	AmersonLin	1
LawrenceO.Hall	AndrewRemsen	1
ManojSyamala	ArunprasadP.Marathe	1
KevinY.Yip	BenKao	2
KevinY.Yip	DavidWai-LokCheung	1
ZhiweiLi	Wei-YingMa	1
MichailVlachos	Jia-JinLe	1
SrikanthBellamkonda	LeiSheng	2
VanithaVaradarajan	OluSobulo	1
OphirFrieder	ClementT.Yu	1
BelaHofhauser	AntoniWolski	1
JohnKomoroske	DavidJensen	1
K.Sel*ukCandan	DivyakantAgrawal	1
YasushiOgawa	HiroshiTakegawa	1
YingHu	TimothyChorma	1
RachelPottinger	ElaineQingChang	1
VukErcegovac	DavidJ.DeWitt	1
JianyingZhou	AmitabhaDas	1
ChaseKrumpelman	ArindamBanerjee	1
DaisukeSaitoh	AtsunobuKaminuma	1
IonutEmilIacob	AlexDekhtyar	1
TingSu	DavidR.Kaeli	1
TedYounglove	BehrokhSamadi	1
XiaohuiYu	NickKoudas	1
UpendraSharma	RohitJain	1
ZonghuanWu	HaiHe	1
RobertLyle	ChunZhang	1
YousukeWatanabe	HiroyukiKitagawa	1
SouravS.Bhowmick	SanjayKumarMadria	1
WolfgangFaber	MichaelFink	1
WisamDakka	KennethR.Wood	1
KunHuang	JoelH.Saltz	1
ShannonHastings	*mitV.*ataly*rek	1
SamuelMadden	MitchCherniack	1
ZonghuanWu	WeiyiMeng	1
MemaRoussopoulos	JeffreyShneidman	1
ShawnR.Jeffery	AnilEdakkunni	1
NoriyoshiYamauchi	KazuoHiyane	1
DavidJ.DeWitt	AndreasHeuer	1
LourdesAraujo	JoseIgnacioSerrano	1
EamonnJ.Keogh	AgenorMafra-Neto	1
Jian-YunNie	GuihongCao	1
PinarSenkul	FarukPolat	1
HelgaVanHerle	AgenorMafra-Neto	1
WingSingWong	BaihuaZheng	1
MoninderSingh	JayantKalagnanam	1
StefanKramer	JohannesFischer	1
OphirFrieder	AbdurChowdhury	1
PatriciaM.West	ClementT.Yu	1
JohanPetrini	CarmenCostilla	1
NgaTran	EdmondLau	1
OphirFrieder	FangLiu	1
OmPrakashVyas	KeshriVerma	1
KevinS.Beyer	GuyM.Lohman	1
SatoshiNakamura	MasakiyoFujimoto	1
NicolasUsunier	Massih-RezaAmini	1
ZhihuaChen	MaryE.Edgerton	1
WeiFan	JoeMcCloskey	1
Seung-HyunJeong	AlvaroA.A.Fernandes	1
PanagiotisG.Ipeirotis	LuisGravano	1
WeiningQian	ShuigengZhou	1
WalidRjaibi	JerryKiernan	1
DanLin	BinCui	1
NingZhang0002	HuaxinZhang	1
WenjuanXing	NesimeTatbul	1
MarkoGrobelnik	DunjaMladenic	2
Jian-TaoSun	Hua-JunZeng	1
ValentinaSvicher	MarkOette	1
SteveBarr	HuiYang	1
Jia-JinLe	JessicaLin	1
EvandroBacarin	EdmundoRobertoMauroMadeira	1
EnriqueCabello	CristinaConde	1
SudhirP.Mudur	BhushanShankarSuryavanshi	1
YoavHorman	GalA.Kaminka	1
JosephYarmus	BorianaL.Milenova	1
YongguangJiang	ChangjieTang	1
FarshadFotouhi	DapengLiu	1
RobertHutchison	ByronChoi	1
NormenSeemann	HamidPirahesh	1
IvanBratko	AleksJakulin	1
YannisPapakonstantinou	IoanaManolescu	1
JacintoGonz*lez-Pach*n	EstherDopazo	1
ShuqingHuang	HuiminChen	1
ZahirBalaporia	WeiJiang	1
TedYounglove	LanYe	1
WendyS.Koegler	W.PhilipKegelmeyer	1
VarunKacholia	SoumenChakrabarti	1
RobertJedicke	AndrewConnolly	1
HolgerSchwarz	BernhardMitschang	1
JagannathanSrinivasan	GeorgeEadon	1
SungMinBae	ChongUnPyon	1
RuiWang0002	RogerS.Barga	1
TakahiraYamaguchi	ShusakuTsumoto	1
GrahamCormode	DiveshSrivastava	1
JianPei	GuozhuDong	1
XiaohuaHu	IllhoiYoo	1
HiroshiInujima	FumihiroKumeno	1
KotagiriRamamohanarao	HamadAlhammady	1
XiaohuaHu	MinSong	2
ZhihaoZhang	XiaomingJin	1
SeanCox	DouglasHolt	1
InderjitS.Dhillon	BrianKulis	1
ManaNakano	AkitsuguWatanabe	1
YongluanZhou	YingYan	1
RolfKaiser	NikoBeerenwinkel	1
GianluigiGreco	EdytaKalka	1
MaheshkumarSabhnani	DanielB.Neill	1
MaureenDougherty	MarcSpraragen	1
PabloAmaya	CarlosGonz*lez	1
LaurentAmsaleg	HlynurHauksson	1
SunilMovva	SaraJ.Graves	1
Sang-HoMoon	Jin-ohChoi	1
ManabuOkumura	KazukoTakahashi	1
XiaoleiLi	DongXin	1
Kian-LeeTan	DhruvMangla	1
SamuelMadden	CarlosGuestrin	1
DanielFleder	AlanS.Abrahams	1
ShiyongLu	FarshadFotouhi	1
MosheKoppel	JonathanSchler	1
FengshanBai	BenyuZhang	1
G*rardGovaert	AllouSam*	1
SridharGullapalli	KaranVahi	1
KanghengWu	JieYin	1
KrithiRamamritham	ArpitJain	1
FranciscoJ.Lucas	FernandoMolina	1
ManabuOhta	ErwanLoisant	1
NicolaH*nle	DanielaNicklas	1
DavidCarmel	AyaSoffer	1
PhillipB.Gibbons	AnastassiaAilamaki	1
RogerZimmermann	KunFu	1
MohamedF.Mokbel	DavidB.Lomet	1
DanSuciu	BhushanMandhani	2
ByronChoi	BingshengHe	1
Rog*riodeLemos	AlanFekete	1
JianLiu	GengfengWu	1
ZhimingDing	RalfHartmutG*ting	1
ChristopherW.Clifton	AnnChristineCatlin	1
StephaneChiocchetti	GeorgeForman	1
JanekMathuria	Chang-TienLu	1
AndrewW.Moore	AndrewConnolly	1
YiqunHuang	HepingHu	1
SpirosPapadimitriou	RistoA.V*is*nen	1
MaytalSaar-Tsechansky	GaryM.Weiss	1
MincaMramor	GregorLeban	1
VivekR.Narasayya	VenkateshGanti	1
OliverPo	Jun'ichiTatemura	1
ThanhTinTang	KathleenGriffiths	1
XiaoleiLi	JiaweiHan	1
YolandaGil	GaurangMehta	1
SaraJ.Graves	RobertAtlas	1
Kyu-YoungWhang	DavidJ.DeWitt	1
TorstenGrust	StefanManegold	1
WolfgangFaber	RiccardoRosati	1
W.NickStreet	SamuelBurer	1
WeiYu	DenisChurin	1
TsuyoshiId*	RyoHirade	1
SunilMovva	DavidEmmitt	1
DanielBarbar*	CarlottaDomeniconi	1
YangDu	DonghuiZhang	1
SanjayChawla	PeiSun	1
TapioPahikkala	SampoPyysalo	1
YasuhiroSuzuki	MasayukiTanimoto	1
ShotaroAkaho	HidetoKazawa	1
GiancarloRuffo	ClaudiaPicardi	1
XiangZhang	SunilPrabhakar	1
TolgaBozkaya	LeiSheng	2
KouzouOhara	HiroshiMotoda	2
NingShang	JiankuiGuo	1
XuanZhou	DhruvMangla	1
LingLiu	BugraGedik	1
ZhiweiLi	MuyuanWang	1
NimrodMegiddo	MarcelKutsch	1
PeterHaider	DavidS.Vogel	1
StefanManegold	MauricevanKeulen	1
NatalieS.Glance	KamalNigam	1
RazvanC.Bunescu	RaymondJ.Mooney	1
KlausKorn	J*rgenK.Rockstroh	1
SusanneE.Hambrusch	AhmedK.Elmagarmid	1
KaidiZhao	BingLiu	2
Mong-LiLee	JunmeiWang	2
TobiasSing	FrancescaCeccherini-Silberstein	1
XiaomeiYu	MarikoHatakeyama	1
SihemAmer-Yahia	GerhardWeikum	1
SandeepMane	AnnePusey	1
PedroCarmona-Saez	AlakaMullick	1
KatsunobuItou	HiroshiFujimura	1
DanielLowd	ChristopherMeek	1
JanChomicki	AlexThomo	1
MasakiyoFujimoto	KazuyaTakeda	1
ZhengSun	Xiang-YangLi	1
NicolasDieu	CosminCremarenco	1
PaoloCappellari	PaoloAtzeni	1
Marie-ClaudeGaudel	BrianRandell	1
RonaldoC.Prati	MariaCarolinaMonard	1
YaliZhu	MarianaJbantova	1
RyanShipley	ParkeGodfrey	1
SatishTadepalli	NarenRamakrishnan	1
RanWolff	DanielKeren	1
MartinD*umer	GerdF*tkenheuer	1
Mih*lyJakob	BernhardMitschang	1
MiltiadisSarakinos	AndreasMeier	1
TakahiroHara	ShojiroNishio	2
XindongWu	WeimingHu	1
YutaOchi	HaruoYokota	1
StefanKramer	EibeFrank	1
RafalRak	OsmarR.Za*ane	1
Willem-JanvandenHeuvel	JeanHenrard	1
PhilippePucheral	LucBouganim	1
ToshihiroUehara	DaiKobayashi	2
QunxiaLi	GangLiu	1
Jos*Mar*aCavero	EsperanzaMarcos	1
YunBai	FangWang	1
Wen-SyanLi	WeiHan	2
MargoI.Seltzer	JeffreyShneidman	1
JunghooCho	AlexandrosNtoulas	1
XiangZhang	AhmedK.Elmagarmid	1
RonenFeldman	BinyaminRosenfeld	2
BrunoM.Fonseca	BerthierA.Ribeiro-Neto	1
CarlosGuestrin	AmolDeshpande	1
StanMatwin	JerffesonTeixeiradeSouza	1
ShuaiChengLi	AnthonyK.H.Tung	1
TaizoYamada	JunAdachi	1
JianhuaFeng	HangGuo	1
LeonardMcMillan	GuodongLiu	1
MuhammadSubianto	ArnoSiebes	1
Min-SooKim0002	Jae-GilLee	2
RobertLyle	Fatma*zcan	1
TolgaBozkaya	AllisonWaingold	1
MinosN.Garofalakis	GrahamCormode	2
Tom*sSingliar	MilosHauskrecht	1
ThomasEiter	GiorgioTerracina	1
XueminLin	HongzhiWang	1
ZacharyG.Ives	RichardT.Snodgrass	1
JoachimHammer	HagenLanger	1
RolfKaiser	GerdF*tkenheuer	1
MasayukiTanimoto	MasatoKoyamaishi	1
XiaoyuanWang	WeiweiSun	1
ToshiakiFujii	MitsuhiroWada	1
PeterKunath	Hans-PeterKriegel	2
SridharGullapalli	PhilipMaechling	1
KatsuyukiSawai	AtsunobuKaminuma	1
JiuyongLi	GrahamJ.Williams	1
XiaogangLi	GaganAgrawal	1
MarkusSpiekermann	FrankHoffmann	1
KazutoYamazaki	GenKawamura	1
CesarBerrospi	Andr*Elisseeff	1
MihoMokuda	MaiSoramoto	1
MatheusRibeiro	JoelH.Saltz	1
M.Powell	GarethJ.Janacek	1
SimonCorston-Oliver	AnthonyAue	1
TakahiroHara	HirokazuTomiyasu	1
EugeneKogan	DenisChurin	1
LongVu	HoaNguyen	1
KazumiKuriyama-Matsumura	AkiHasegawa	1
MoChen	Jian-TaoSun	1
YukoMaruyama	KenjiYamanishi	1
Massih-RezaAmini	AnastasiosTombros	1
YunboCao	ShenjieLi	1
MartinEster	JianPei	1
MarcSpraragen	KaranVahi	1
PeterJ.Haas	MarcelKutsch	1
StanleyB.Zdonik	PatrickE.O'Neil	1
StevenMinton	CraigA.Knoblock	1
PeterJ.Haas	NingZhang0002	1
ThomasR*lleke	JayavelShanmugasundaram	1
ThijsWesterveld	GeorginaRam*rez	1
LorraineMcGinty	JamesReilly	1
JonathanLedlie	ChakiNg	1
Wook-ShinHan	ByungSukLee	1
YaqinWang	YangyongZhu	1
Ying-HanLiu	Jeng-KuenChiu	1
AndrewWitkowski	AllisonWaingold	1
J.EliotB.Moss	GerhardWeikum	1
RadaChirkova	DimitriosGunopulos	1
ZhaoHuiTang	JieTang	1
MouradOuzzani	JeffreyScottVitter	1
DavidD.Lewis	AbdurChowdhury	1
ZhihuaZhang	GangWu	1
Min-OkJung	JongHyunPark	1
SanasamRanbirSingh	NingthoujamGourakishwarSingh	1
MichaelHoey	HenryKon	1
MichaelRys	DanielaFlorescu	1
TetsuyaIkeda	HirokoMano	1
HiroyukiKitagawa	AtsuyukiMorishima	1
PereAlbert*	CarlosSa*udo	1
Jos*Martinez	ErwanLoisant	1
RicardoSilva	JijiZhang	1
R*gisSaint-Paul	GuillaumeRaschia	1
IsaacChankai	HyoilHan	1
RossSparks	GrahamJ.Williams	1
PadraigCunningham	DerekGreene	1
MichaelK.Ng	BenKao	1
LaksV.S.Lakshmanan	ElaineQingChang	1
XinZheng	Tie-YanLiu	1
SrikanthSampath	BharatRane	1
YoshinobuYamashita	TadashiOhmori	1
MeteCelik	JinSoungYoo	1
KevinChen-ChuanChang	ChengkaiLi	2
VojkanMihajlovic	HenkErnstBlok	1
SunilPrabhakar	ReynoldCheng	4
KazumasaYamamoto	ChiyomiMiyajima	1
StanZ.Li	JunpingZhang	1
SouravS.Bhowmick	LeGruenwald	2
ShivakumarVaithyanathan	DavidGondek	1
VarunKacholia	HrishikeshKarambelkar	1
XiaolingWang	ShengHuang	1
StanSclaroff	PanagiotisPapapetrou	1
RosieJones	GiridharKumaran	1
VanjaJosifovski	RobertaCochrane	1
SriramMohan	ArijitSengupta	1
YongtaiZhu	ChenWang	1
XiaohuiYu	KenQ.Pu	1
LinhaoXu	AoyingZhou	1
HongzhiWang	HaifengJiang	1
Yen-KuangChen	AnthonyD.Nguyen	1
SatoshiNakamura	AkiraSasou	1
TorstenGrabs	C*sarA.Galindo-Legaria	1
QiangWang	GuoLi	1
Marie-ClaudeGaudel	HenryF.Korth	1
NicolaLeone	DomenicoLembo	1
S.Sudarshan	HrishikeshKarambelkar	1
MartinD*umer	FrancescaCeccherini-Silberstein	1
MatthiasSchubert	Hans-PeterKriegel	3
KevinDrummey	EdGreengrass	1
RiccardoRosati	NicolaLeone	1
HyoilHan	AnnPrestrud	1
NipunAgarwal	Anh-TuanTran	1
YoshikazuShima	KouichiHirata	1
YasuhiroSuzuki	TomohiroEndo	1
JuanJos*delCoz	AntonioBahamonde	1
JayantR.Haritsa	A.Kumaran	1
TorstenGrust	MauricevanKeulen	1
BharatRane	AnupamSingh	1
WeiZhao	JianerChen	1
Ya-HuiChang	GregLiu	1
LaksV.S.Lakshmanan	IriniFundulaki	1
GaryM.Weiss	BiancaZadrozny	1
KevynCollins-Thompson	JamieCallan	1
YuniXia	ReynoldCheng	1
RobertWingPongLuk	Chak-manNg	1
RichardHull	EllisHorowitz	1
Pui-yingTang	Fu-LaiChung	1
XuanHieuPhan	MinhLeNguyen	1
TatsuoTsuji	NaokiAmma	1
MarioDiwersy	ChristianHerzog	1
MitchCherniack	AdamBatkin	1
WolfgangFaber	WitoldStaniszkis	1
RaymondJ.Mooney	PremMelville	1
WenyinLiu	NingLiu	1
FrancisPang	AnupamSingh	1
XiaokuiXiao	SunilPrabhakar	1
YidongYuan	JeffreyXuYu	1
KaiMingTing	FeiTonyLiu	1
StevenM.Beitzel	EricC.Jensen	1
TolgaBozkaya	AndrewWitkowski	2
NileshN.Dalvi	JihadBoulos	1
YoTakano	HidetomoNabeshima	1
ShengHuang	DunluPeng	1
ToreRisch	MilenaIvanova	1
LucaGrieco	DomenicoLembo	1
ZhiyuanChen	FlipKorn	1
WouterAlink	AnderdeKeijzer	1
FelixNaumann	AlexanderBilke	2
PhilipA.Bernstein	JenniferWidom	1
DonaldKossmann	AlexanderKreutz	1
MitsunoriMizumachi	AkiraSasou	1
MaudeManouvrier	Genevi*veJomier	1
FrankK.H.A.Dehne	AndrewRau-Chaplin	1
TamMinhTran	PeterJ.Haas	1
EdwardA.Fox	BaopingZhang	2
StefanoLonardi	NitinKumar	1
TimothyM.McPhillips	ShawnBowers	1
GarethJ.Janacek	AnthonyJ.Bagnall	1
JeanHenrard	CarmenCostilla	1
Ugur*etintemel	AnjaliJhingran	1
ValentinJijkoun	MaartendeRijke	1
RiccardoRosati	MarcoRuzzi	2
XiaofangZhou	GuorenWang	1
RobertJedicke	JeremyKubica	1
MustafaAtay	DapengLiu	1
Lu*sRodrigues	GerhardWeikum	1
Shou-JianYu	JessicaLin	1
Marie-ClaudeGaudel	AlexanderB.Romanovsky	1
RicardodaSilvaTorres	GilbertoZontaPastorelloJr.	1
RicardoVilalta	ChristophF.Eick	1
ZhongmingHan	CongtingXi	1
JianliangXu	DikLunLee	2
SuminSong	IhabF.Ilyas	1
SandeepMane	San-YihHwang	1
Min-WooLee	Byung-KyuKim	1
NickKoudas	DavidToman	1
TolgaBozkaya	NathanFolkert	1
J.EliotB.Moss	BrianRandell	1
GuofeiJiang	CristianUngureanu	1
WeipingXie	BoxuanZhai	1
ZhengLiu	WeiWang0011	1
JulienPrados	EltonRexhepaj	1
Ding-YingChiu	ArbeeL.P.Chen	1
SourashisRoy	SandeepPandey	1
IbrahimKamel	AbdelsalamHelal	1
RicardoVilalta	Chun-ShengChen	1
HaukeWalter	Carlo-FedericoPerno	1
DaisukeSaitoh	AkinobuLee	1
XiaonanJi	GuozhuDong	1
KiyohiroShikano	DaisukeSaitoh	1
GiovambattistaIanni	GeorgGottlob	1
MauroBiajiz	JanderMoreira	1
BalakrishnaR.Iyer	AmrElAbbadi	2
WeiWang0010	JanPrins	1
JorgeD*ez	AntonioBahamonde	1
ZunpingCheng	Xu-binDeng	1
PeterR.Pietzuch	MemaRoussopoulos	1
LeiSheng	AmanNaimat	1
MatthewSiegler	MatthewHurst	1
WenfeiFan	RajeevRastogi	2
PeerKr*ger	AlexeyPryakhin	1
TokWangLing	TingChen	2
KenjiAraki	HiroshiEchizen-ya	1
KenC.K.Lee	JingZhou	1
YangboZhu	XingLi	1
XiangminZhou	GuorenWang	1
SihemAmer-Yahia	NickKoudas	2
PhokionG.Kolaitis	JasmineNovak	1
LiangxiaoJiang	JiangSu	1
MarianoP.Consens	AdrianM.Teisanu	1
WataruNakano	SatoshiNaoi	1
StefanoLonardi	Chotirat(Ann)Ratanamahatana	2
XiaolinLi	XiangdongHe	1
SharadMehrotra	DmitriV.Kalashnikov	1
RuneS*tre	AstridL*greid	1
LimsoonWong	HaiquanLi	1
RobCardwell	RandallHauch	1
TatjanaWelzer-Druzovec	BrunoStiglic	1
MarianoP.Consens	AlbertoO.Mendelzon	1
ChristophMangold	BernhardMitschang	1
ZhenHuaLiu	MuralidharKrishnaprasad	3
QiangYe	LouiqaRaschid	1
ShawnR.Jeffery	NathanBurkhart	1
TharamS.Dillon	ElizabethChang	1
KamranKarimi	HowardJ.Hamilton	1
WeiFan	JanekMathuria	1
SouripriyaDas	GeorgeEadon	1
RistoA.V*is*nen	PanayiotisTsaparas	1
ArnonRosenthal	AlonY.Halevy	1
JosephM.Hellerstein	DavidJ.DeWitt	1
WenjuanXing	AnuragMaskey	1
SaneyasuYamaguchi	MasatoOguchi	3
ShivnathBabu	RajeevMotwani	1
XiaoyangSeanWang	SushilJajodia	1
Ugur*etintemel	AnuragMaskey	1
ToshikiEndo	ChiyomiMiyajima	1
WolfgangFaber	MarcoRuzzi	1
ValentinaSvicher	RolfKaiser	1
VenkataNishanthLolla	EamonnJ.Keogh	1
LeopoldoE.Bertossi	JanChomicki	1
PatCase	GerhardWeikum	1
VipinGupta	SridharGullapalli	1
XiaofangZhou	HengTaoShen	1
RaghuRamakrishnan	Bee-ChungChen	1
Wei-YingMa	Hua-JunZeng	1
VivekR.Narasayya	LuborKoll*r	1
RongPan	JieYin	1
WeiFan	IanDavidson	1
VikasArora	Anh-TuanTran	1
ZacharyG.Ives	AndreasHeuer	1
ManabuOhta	Jos*Martinez	1
HuanmeiWu	BettySalzberg	1
PaavoArvola	JaanaKek*l*inen	1
QixiangSun	PrasannaGanesan	1
YaronKanza	BennyKimelfeld	1
HaoHe	HaixunWang	1
WeiyiMeng	DavidA.Grossman	1
JessicaLin	EamonnJ.Keogh	2
DongtaoLi	ChunyanMiao	1
SrikanthBellamkonda	ShrikanthShankar	1
TamMinhTran	NimrodMegiddo	1
PhilipS.Yu	KirstenHildrum	1
JeffreyScottVitter	AhmedK.Elmagarmid	1
ErginElmacioglu	DongwonLee	1
SangHoLee	JeongSeokOh	1
Ugur*etintemel	NesimeTatbul	1
XifengYan	HwanjoYu	1
HolgerMeyer	ChristianS.Jensen	2
XiangLi	SaraJ.Graves	1
LouiqaRaschid	AvigdorGal	1
VincenzinoLio	GeorgGottlob	1
ZhengChen	BenyuZhang	2
XiaohuaZhou	HyoilHan	1
MuyuanWang	LieLu	1
MarkusSpiekermann	DirkAnsorge	1
TimothyMalkemus	LeslieCranston	1
JihieKim	GaurangMehta	1
TakahikoIto	MasashiShimbo	1
RajaBose	MohamedH.Ali	1
RakeshAgrawal	RaghuKrishnapuram	1
AngelikaReiser	AlfonsKemper	1
ThomasA.Russ	GurmeetSingh	1
VarunKacholia	ShashankPandit	1
WolfgangFaber	DomenicoLembo	1
SugatoBasu	MehranSahami	1
YannisE.Ioannidis	GeorgiaKoutrika	3
LuisGravano	AlexandrosNtoulas	1
NicolasWerro	AndreasMeier	1
SusanPaulsen	JinzeLiu	1
Yi-ChengTu	ReynoldCheng	1
ChristopherB.Colohan	AnastassiaAilamaki	1
YuhuiQiu	FangWang	1
YufeiTao	NikosMamoulis	2
LucMoreau	IanT.Foster	1
RosieJones	OmidMadani	1
Sang-HoMoon	Jin-DeogKim	1
YunChi	PhilipS.Yu	2
YingLi	Honghua(Kathy)Dai	1
H*ctorAllende	CarlosValle	1
JieChen	HuidongJin	1
KrithiRamamritham	AlexanderB.Romanovsky	1
SaeHwang	JeongKyuLee	1
TorstenGrust	JanRittinger	1
RachelPottinger	DimitriosGunopulos	1
ZhimingDing	FrankHoffmann	1
NesimeTatbul	BradleyBerg	1
YingHu	SeemaSundara	1
GideonSchaller	AdrianBaras	1
MoustafaGhanem	HongboXu	1
LijunXu	KanglinXie	1
JoostN.Kok	AdriaanP.IJzerman	1
YaliZhu	BradleyMomberger	1
RobertaCochrane	JimKleewein	1
YuqingWu	ArijitSengupta	1
Wang-ChienLee	JianliangXu	1
VicentePelechano	JavierMu*oz	1
Per-*keLarson	HongfeiGuo	1
JiongYang	AnthonyK.H.Tung	2
RajaBose	AhmedK.Elmagarmid	1
ThomasSeidl	IraAssent	1
LimsoonWong	JianPei	1
XiaofengZhang	WilliamK.Cheung	1
TimRey	AlexN.Kalos	1
FernandoA.DasNeves	DmitriRoussinov	2
MasatoKitajima	HideoMatsuda	1
RaviKumar	AndrewTomkins	4
TaizoYamada	KenroAihara	1
AmersonLin	AdamBatkin	1
Yi-HungWu	Chung-WenCho	1
Mohand-SaidHacid	HangzaiLuo	2
SukhoLee	PraveenRao	1
HelgaVanHerle	EamonnJ.Keogh	1
JeremyKubica	AndrewConnolly	1
TheoVassilakis	SurajitChaudhuri	1
HasanOgul	*.ErkanMumcuoglu	1
GajananS.Chinchwadkar	BharatRane	1
SatoshiNakamura	NorihideKitaoka	1
KlausKorn	FrancescaCeccherini-Silberstein	1
JimKleewein	HamidPirahesh	1
MelanieWeis	AlexanderBilke	1
LeonidNovak	AlexandreV.Zamulin	1
XinyuGuo	NanWang	1
JiankuiGuo	Fang-zhongSu	1
VadirajaBhatt	Ghazi-NourdineBenadjaoud	1
YukiyoTakasago	KatsunoriYamaoka	1
TobiasScheffer	PeterSiemen	1
P.P.S.Narayan	MichaelFlaster	1
MuraliMani	HongSu	1
Ugur*etintemel	Jeong-HyonHwang	2
SourashisRoy	SoumenChakrabarti	1
LingLiu	KekeChen	1
YunboCao	HangLi	2
JohnZeleznikow	Hong-CheuLiu	1
PhilipA.Bernstein	PeterMork	1
JiuyongLi	JieChen	1
RajeevMotwani	KameshMunagala	1
Jean-MarcPetit	FabienDeMarchi	2
YahyaSlimani	GhadaGasmi	1
WenjuanXing	StanleyB.Zdonik	1
LinQiao	AmrElAbbadi	2
MaurizioLenzerini	BartoszNowicki	1
HlynurHauksson	Bj*rn**rJ*nsson	1
KaiSimon	GeorgLausen	1
MariaIsabelSobralEscada	DaltonM.Valeriano	1
SrinivasanParthasarathy	DmitriiPolshakov	1
RicardodaSilvaTorres	P*velCalado	1
J.EliotB.Moss	CliffB.Jones	1
NadiaGhamrawi	AndrewMcCallum	1
NadavEiron	MarcusFontoura	1
IngoJ.Timm	HagenLanger	1
SudarshanLamkhede	RohiniK.Srihari	1
JohannesGehrke	JayavelShanmugasundaram	2
MarcoRuzzi	GeorgGottlob	1
HuimingQu	DeepayanChakrabarti	2
XiaorongLi	WeipingGe	1
SylvainGuinepain	LeGruenwald	1
FarshadFotouhi	ArtemChebotko	1
NickKoudas	BengChinOoi	1
MariaIsabelSobralEscada	MarcelinoPereiradosSantosSilva	1
GiladMishne	DavidCarmel	1
T.S.Jayram	ShivakumarVaithyanathan	1
TakahiroIkeda	HirokiArimura	1
SunilPrabhakar	ShanLei	1
MehediMasud	JohnMylopoulos	1
NassimaDjafri	KeithT.Mason	1
PengyueJ.Lin	DouglasHolt	1
JianzhongLi	HongzhiWang	1
YutaOchi	WataruNakano	1
JunMiyazaki	AlejandroJaimes	1
QiangZhu	HongGuo	1
Ay*aAzginHintoglu	AliInan	1
YingXing	OlgaPapaemmanouil	1
Marie-ClaudeGaudel	GerhardWeikum	1
XiaodanSong	Ching-YungLin	1
SunitaSarawagi	GaneshRamakrishnan	1
WeeKeongNg	Kok-LeongOng	1
XuelongLi	DachengTao	1
HenryG.Goldberg	*zg*rSimsek	1
VassilisPapadimos	JinLi	2
YolandaGil	EwaDeelman	1
SeanCox	LanYe	1
ShinichiUeshima	MayumiUeda	1
Lu*sRodrigues	AlanFekete	1
JinyanLi	HaiquanLi	1
QiongLuo	DyceJingZhao	1
JoachimHammer	IngoJ.Timm	1
KaiYu	Hans-PeterKriegel	2
ThomasH*se	FrankHoffmann	1
PhokionG.Kolaitis	CalistoZuzarte	1
JohannesGehrke	DiveshSrivastava	1
PanosKalnis	Kian-LeeTan	1
Jian-WeiLiu	JessicaLin	1
YiHuang	KaiYu	1
DominiqueLaurent	AnneLaurent	1
RutSiguroardottir	Bj*rn**rJ*nsson	1
OliverSeeliger	DraganTomic	1
AssafSchuster	AmirBar-Or	1
YaronKanza	SaraCohen	1
GangWang	FrederickH.Lochovsky	1
PhillipB.Gibbons	AmitManjhi	1
MatthiasBender	GerhardWeikum	1
SharmaChakravarthy	AkshayaArora	1
VasilisMegalooikonomou	RolfLak*mper	1
JongHyunPark	Ji-HoonKang	1
SiegfriedNijssen	MohammedJaveedZaki	1
ShingoKuroiwa	MasakiyoFujimoto	1
YuelongJiang	AdaWai-CheeFu	1
YingXing	StanleyB.Zdonik	2
AmbujK.Singh	AhmetBulut	1
JunYang0001	HaoHe	3
WataruUchida	TakahiroHara	1
YuhanCai	JayantMadhavan	1
ThomasBehr	DirkAnsorge	1
DonatoMalerba	AnnalisaAppice	1
MichaelJ.Franklin	MatthewDenny	1
VittorioCastelli	PhilipS.Yu	2
ThomasGeorge	SrujanaMerugu	1
HuiZhang0002	ChristopheDiot	1
SamuelMadden	NgaTran	1
JihieKim	CarlKesselman	1
GiancarloRuffo	DanieleGunetti	1
SteveB.Jiang	GregoryC.Sharp	1
RafaelRum*	BarryR.Cobb	1
WaiGenYee	RatkoOrlandic	1
RameshGovindan	FangBian	1
AleksanderKolcz	AbdurChowdhury	2
MartinBrooks	DanielLemire	1
DanielaNicklas	BernhardMitschang	1
XiaodanSong	Ming-TingSun	1
StanleyB.Zdonik	MiguelFerreira	1
MatheusRibeiro	KunHuang	1
JingkaiYu	FarshadFotouhi	1
WalidG.Aref	MohamedH.Ali	1
Han-ShenHuang	Chun-NanHsu	1
MayssamSayyadian	ArnonRosenthal	1
ThorstenMeinl	IngridFischer	1
WeiWang0011	HaifengJiang	1
HiroshiTakegawa	HideoItoh	1
HansChalupsky	GurmeetSingh	1
HeikkiMannila	AristidesGionis	3
YueZhao	ShuigengZhou	1
QuocLe	AnHaiDoan	1
LeiTang	HuanLiu	1
SebastianMichel	PeterTriantafillou	2
VincenzinoLio	EdytaKalka	1
MartinD*umer	MarkOette	1
JialieShen	AnneH.H.Ngu	1
XiaomeiYu	AkihikoKonagaya	1
NickCraswell	KathleenGriffiths	1
PeterKunath	MartinPfeifle	2
ShishirAgrawal	M.Tamer*zsu	1
KouTakahashi	IsamuShioya	1
JorgeD*ez	CarlosSa*udo	1
TakashiHonishi	MakotoOnizuka	1
GuyM.Lohman	BertVanderLinden	1
PhilipS.Yu	JunYang0001	1
Wolf-TiloBalke	JasonXinZheng	1
WalidG.Aref	AbdelsalamHelal	1
MichalisVazirgiannis	MagdaliniEirinaki	1
Andr*Elisseeff	AbderrahimLabbi	1
YufeiTao	ReynoldCheng	1
VolkerMarkl	VijayshankarRaman	1
XinLi	WeiHong	2
RongPan	KanghengWu	1
Lu*sRodrigues	AlexanderB.Romanovsky	1
Wei-YingMa	HaoWan	1
MuhammadSubianto	A.J.Feelders	1
SamuelMadden	PatrickE.O'Neil	1
HuiminChen	HenryL.BartJr.	1
MinWang	JeffreyScottVitter	1
ThomasLengauer	KlausKorn	1
Tzi-ckerChiueh	DhruvPilania	1
PhilipS.Yu	JeffreyXuYu	2
JianminWang	DeyiLi	1
Wing-KaiHon	ArifGhafoor	1
Wolf-TiloBalke	UweThaden	1
JimengSun	ChristosFaloutsos	4
VanaKalogeraki	DemetriosZeinalipour-Yazti	1
StefanB*ttcher	CharlesL.A.Clarke	1
FabrizioSebastiani	AndreaEsuli	1
ShipengYu	KaiYu	2
ShigekiMatsubara	HiroshiFujimura	1
AndrewWitkowski	AmanNaimat	1
YolandaGil	GarrickStaples	1
TonyPan	*mitV.*ataly*rek	1
MafruzZamanAshrafi	KateA.Smith	1
DeanJacobs	BillGallagher	1
DavidJensen	BrianNeilLevine	1
KurtW.Deschler	ElkeA.Rundensteiner	1
VilasWuwongse	ChutipornAnutariya	1
YoshinoriHara	SangKyunCha	1
SrinivasanParthasarathy	ChaoWang	1
Xu-binDeng	Fang-zhongSu	1
SanjayChawla	BavaniArunasalam	1
WenfeiFan	JeffreyXuYu	1
MariaSalam*	BarrySmyth	1
YasuhiroInazumi	AkiKobayashi	1
TetsuyaIkeda	TakuyaHiraoka	1
GiacomoGamberoni	EvelinaLamma	1
NorihideKitaoka	MitsunoriMizumachi	1
ShipengYu	MatthiasSchubert	1
YunhuaHu	HangLi	1
RiccardoRosati	GianluigiGreco	1
TerenceHo	ElaineQingChang	1
DaxinJiang	AidongZhang	3
TakahiroKosaka	KentaroWakatsuki	1
WeiguoFan	DmitriRoussinov	2
SarunasGirdzijauskas	AnwitamanDatta	1
Wing-KaiHon	JeffreyScottVitter	1
NingZhang0002	GuyM.Lohman	1
ValentinaSvicher	HaukeWalter	1
TimFurche	Fran*oisBry	1
ShiweiTang	DongqingYang	1
ThomasBehr	RalfHartmutG*ting	2
JonathanLedlie	DavidA.Holland	1
Zhongfei(Mark)Zhang	BoLong	2
JosephTerry	DavidEmmitt	1
HaiboHu	DikLunLee	2
EdytaKalka	DomenicoLembo	1
MichaelK.Ng	JoshuaZhexueHuang	1
VasantHonavar	OksanaYakhnenko	1
Kun-TaChuang	Hung-LengChen	1
RongPan	DouShen	1
PetraPovalej	BrunoStiglic	1
KouzouOhara	AlexandreTermier	1
ZhengdingLu	HepingHu	1
GiorgioTerracina	DomenicoLembo	1
HeikkiMannila	AnttiUkkonen	1
LawrenceB.Holder	DianeJ.Cook	1
YoshikazuShima	MasateruHarao	1
MasaoSakata	KatsuyukiSawai	1
XiaofeiHe	JiaweiHan	1
JianPei	AidongZhang	3
ValentinaSvicher	J*rgenK.Rockstroh	1
WenQiangWang	BengChinOoi	1
XiaoxinYin	JiaweiHan	3
ReinerKraft	FarzinMaghoul	1
Seung-wonHwang	KevinChen-ChuanChang	2
VishalSikka	MichaelJ.Carey	1
MaithiliNarasimha	GeneTsudik	1
ZhaogongZhang	JianzhongLi	1
VijayshankarRaman	MokhtarKandil	1
KiyoungYang	HyunjinYoon	1
MustafaAtay	FarshadFotouhi	1
MoonjungCho	DavidWai-LokCheung	1
HamidPirahesh	GuyM.Lohman	1
ToshihiroKamishima	HidetoKazawa	1
XueminLin	QingLiu	1
SamKwong	HanliWang	1
NormenSeemann	GeorgeLapis	1
MarkoGrobelnik	JafarAdibi	1
NarenRamakrishnan	ChrisBailey-Kellogg	1
VasilisMegalooikonomou	EamonnJ.Keogh	1
ShivakumarVaithyanathan	DouglasBurdick	1
PeiyaLiu	FushengWang	1
SteveBridges	RolfSchimpfky	1
RonaldK.Pearson	AlanHochberg	1
NazliGoharian	LingMa	1
TobiasScheffer	PeterHaider	1
TuanNamTran	TuBaoHo	1
MatthiasNicola	BertVanderLinden	1
IrinaRozenbaum	GrahamCormode	1
ErhardRahm	AndreasThor	1
ChristosFaloutsos	AristidesGionis	1
VikramPudi	RavindranathJampani	1
DavidWai-LokCheung	BenKao	1
YutakaKatsuyama	SatoshiNaoi	1
StefanManegold	JanRittinger	1
VincentOria	LaurentAmsaleg	1
GeorgeKollios	DimitriosGunopulos	1
VictorM.Markowitz	NataliaIvanova	1
MarcoRuzzi	DomenicoLembo	2
WenfeiFan	JianhuaLu	1
RenatoFerreira	JoelH.Saltz	1
MichaelK.Ng	DavidW.Cheung	2
Wook-ShinHan	Jae-GilLee	1
ToshihideSutou	HajimeKitakami	1
XiaomeiYu	AkiHasegawa	1
SteveB.Jiang	DavidR.Kaeli	1
RonHoory	AyaSoffer	1
Yong-HeeLee	Min-OkJung	1
YuchangGong	XingXie	1
KatsunoriYamaoka	AkiKobayashi	2
TahsinM.Kur*	ScottOster	1
RajeevRastogi	MinosN.Garofalakis	1
MitsunoriMizumachi	KazuyaTakeda	1
ShigehikoKanaya	KenKurokawa	1
Shin'ichiKobayashi	KazuoHiyane	1
RuiYang	PanosKalnis	1
YanifAhmad	AnuragMaskey	1
VincenzinoLio	MichaelFink	1
VanaKalogeraki	DimitriosGunopulos	1
JosephM.Hellerstein	FrederickReiss	1
EsperanzaMarcos	CarmenCostilla	1
JunGuo	HaifengShen	1
MehmetDundar	GlennFung	1
TadashiOhmori	MamoruHoshi	1
RicardoCartaxoModestodeSouza	GilbertoC*mara	1
PhilipS.Yu	Chang-ShingPerng	1
GideonSchaller	DraganTomic	1
RuiWang0002	GermanShegalov	1
SungRanCho	DiveshSrivastava	1
DivyakantAgrawal	AmbujK.Singh	1
YuXu	LathaS.Colby	1
KazuakiUeda	KanameAmano	1
RobertB.Allen	MinSong	1
TahsinM.Kur*	RenatoFerreira	1
TobiasScheffer	SteveBridges	1
Fran*oisBry	DanOlteanu	1
QuocLe	LongVu	1
PadhraicSmyth	JonHutchins	1
RajeevRastogi	GrahamCormode	1
I.V.Ramakrishnan	AmarjeetSingh	1
RuggeroG.Pensa	Jean-Fran*oisBoulicaut	2
TaoLi	FengLiang	1
Marie-ClaudeGaudel	Lu*sRodrigues	1
Jos*A.Blakeley	ConorCunningham	1
GianluigiGreco	BartoszNowicki	1
SongboTan	HongboXu	1
TakamichiMiyata	AkiKobayashi	1
ZhimingDing	UlrichTelle	1
TheodoreJohnson	IrinaRozenbaum	1
HaixunWang	ChangLuo	1
SampoPyysalo	JormaBoberg	1
MichaelJ.Carey	DinaBitton	1
WanxiaXie	SushilK.Prasad	1
FangLiu	DavidA.Grossman	1
MakotoOnizuka	HiroyukiUchiyama	1
FangChu	DouglasStottParkerJr.	1
Juan-CarlosJusem	BilahariAkkiraju	1
LingzhiZhang	JayantR.Haritsa	1
JonathanStoeckel	GlennFung	1
VikasArora	MuralidharKrishnaprasad	3
WojciechStach	OsmarR.Za*ane	1
Wing-KaiHon	SusanneE.Hambrusch	1
VincenzinoLio	GianluigiGreco	1
RongPan	Jian-TaoSun	1
Min-WooLee	JongHyunPark	1
SeokIlSong	JaeSooYoo	1
LeiJiang	IlujuKiringa	1
YutaOchi	TakashiKobayashi	1
SurajitChaudhuri	ManojSyamala	1
ShuichiKurabayashi	NobukoMiura	1
SugatoBasu	MikhailBilenko	1
PaoloAvesani	FrancescaDemichelis	1
DieterPfoser	CarolaWenk	1
SusumuDate	GenKawamura	1
SteveBarr	RaghuMachiraju	1
Ugur*etintemel	MichaelStonebraker	3
ShinjiShimojo	ReijiTeramoto	1
JingPeng	JianjunHu	1
GeorgiaKoloniari	EvaggeliaPitoura	2
WenfeiFan	P.P.S.Narayan	1
PrasannaKumarDesikan	JaideepSrivastava	1
WarrenShen	AlexanderKramnik	1
HansChalupsky	BrianMendenhall	1
ThomasR*lleke	GerhardWeikum	1
VanjaJosifovski	PeterJ.Haas	1
VasileiosMegalooikonomou	GuoLi	1
ThomasR*lleke	PatCase	1
ViswanathanKrishnamurthy	DanielaFlorescu	1
JohnKomoroske	*zg*rSimsek	1
TolgaBozkaya	SrikanthBellamkonda	2
TaeSikHan	DongwonLee	1
TonyPan	ShannonHastings	1
TokWangLing	JiahengLu	3
RonHoory	DavidCarmel	1
XuehuaShen	BinTan	1
ErhardRahm	AlonY.Halevy	1
ToshikiEndo	KazumasaYamamoto	1
Tong-WenLee	Leuo-hongWang	1
OliverPo	K.Sel*ukCandan	1
RajeevMotwani	JenniferWidom	1
TsuyoshiId*	TadashiTsumura	1
UmeshwarDayal	FabioCasati	1
KazuyaTakeda	KatsunobuItou	1
ParaskevasV.Lekeas	ChenLi	1
HolgerMeyer	DavidJ.DeWitt	1
Kyu-YoungWhang	AndreasHeuer	2
MasayukiKuroda	KenHiguchi	1
RichardNock	BabakEsfandiari	1
FuatAkal	CanT*rker	1
Kian-LeeTan	AnthonyK.H.Tung	1
NicolaLeone	GianluigiGreco	1
YannisPetrakis	GeorgiaKoloniari	1
SandeepYaramakala	DimitrisMargaritis	1
QiongLuo	BingshengHe	1
PedroCoutinho	M*rioJ.Silva	1
TetsuyaIshie	KazunoriSunako	1
GiulianoTirenni	Andr*Elisseeff	1
SheilaA.Greibach	MichaelA.Harrison	1
QiongLuo	HongboFu	1
RalfHartmutG*ting	DirkAnsorge	1
ThomasNeumann	SvenHelmer	1
RobertStockton	MatthewHurst	1
TakashiBaba	KazuakiUeda	1
MatheusRibeiro	*mitV.*ataly*rek	1
RolfLak*mper	LonginJanLatecki	2
KiyohiroShikano	HiroshiSaruwatari	1
VijayKumar	SujataBanerjee	1
HangzaiLuo	ElisaBertino	1
Tie-YanLiu	HaoWan	1
XuedongChen	ElizabethJ.O'Neil	1
WangZhang	MasaruKitsuregawa	1
WeiFan	Chang-TienLu	1
ManueldelValle	LuisF.Lago-Fern*ndez	1
Kyu-YoungWhang	Jae-GilLee	2
ShahabKamali	MortezaMonemizadeh	1
DivyakantAgrawal	ArsanySawires	1
HaiHe	ClementT.Yu	1
ZhihuaZhang	FrederickH.Lochovsky	1
RobertAtlas	Juan-CarlosJusem	1
OliverPo	ArsanySawires	1
SamuelMadden	AmersonLin	1
VanithaVaradarajan	RobertMcCann	1
ToreRisch	JeanHenrard	1
DivyakantAgrawal	BalakrishnaR.Iyer	2
TomM.Mitchell	R.BharatRao	1
StefanoCeri	DanieleBraga	1
QiangWang	EamonnJ.Keogh	2
YuDeng	V.S.Subrahmanian	1
LauraChiticariu	GauravVijayvargiya	1
WeiHong	RamakrishnaGummadi	1
ZunpingCheng	YangyongZhu	1
XiaopengXiong	WalidG.Aref	1
ShahabKamali	MohammadGhodsi	1
NormenSeemann	BrianVickery	1
JustinZobel	AlistairMoffat	2
ShengMa	EmreErdogan	1
RichardT.Snodgrass	DavidJ.DeWitt	1
DikLunLee	BaihuaZheng	2
YanivBernstein	AlistairMoffat	1
JianhuaLu	JeffreyXuYu	1
EdwardA.Fox	AlexandreX.Falc*o	1
ConorCunningham	BalajiRathakrishnan	1
SergeyMelnik	PhilipA.Bernstein	2
MichaelJ.Franklin	AnilEdakkunni	1
YolandaGil	CarlKesselman	1
TimothyEdmunds	ShinjiroSueda	1
Yi-ChengTu	SunilPrabhakar	1
JanezDemsar	IvanBratko	1
Tzung-ShiChen	Shih-ChunHsu	1
VasileiosMegalooikonomou	ChristosFaloutsos	1
ArifGhafoor	AhmedK.Elmagarmid	1
JeffreyScottVitter	ChristopherW.Clifton	1
TamMinhTran	MarcelKutsch	1
SusumuDate	MasatoKitajima	1
HiroshiSaruwatari	AkinobuLee	1
ZijianZheng	YingLi	1
WangKayNgai	ReynoldCheng	1
WeiminXiao	BingLiu	2
WilfriedTeiken	Keh-ShinF.Cheng	1
RaymondChi-WingWong	KeWang	1
M.Tamer*zsu	DavidJ.DeWitt	1
TyroneGrandison	JerryKiernan	1
ThomasKabisch	JeanHenrard	1
BengChinOoi	AoyingZhou	1
YingChen	DongZhuang	1
HeikkiMannila	FotoN.Afrati	1
ChangLuo	CarloZaniolo	1
Tat-SangChoy	RaghuMachiraju	1
YokoKamidoi	TakeshiFushimi	1
ClementT.Yu	CarloCurino	1
RajBhatnagar	HaiyunBian	2
P*velCalado	MarcosAndr*Gon*alves	2
Min-OkJung	Ji-HoonKang	1
Shou-JianYu	MichailVlachos	1
PanagiotisKarras	NikosMamoulis	1
VictorVianu	RichardHull	1
RonHoory	GiladMishne	1
SugatoBasu	JoydeepGhosh	1
Thanh-DuyNguyen	AlbrechtSchmidt0002	1
JeffPollock	DinaBitton	1
PhilipChan	DragosD.Margineantu	1
J*rgenK.Rockstroh	Carlo-FedericoPerno	1
MokhtarKandil	DanielC.Zilio	1
TuongC.Truong	KevinS.Beyer	1
YasuhiroSuzuki	MitsuhiroWada	1
TonyPan	TahsinM.Kur*	1
VijayKumar	PanosK.Chrysanthis	1
XiangZhang	ElisaBertino	1
KedarDhamdhere	AmitManjhi	1
RajaBose	MohamedF.Mokbel	1
TimFurche	MarkusSpannagel	1
NikhilS.Ketkar	DianeJ.Cook	1
SubramanianArumugam	AlinDobra	1
PrasadDeshpande	DouglasBurdick	1
StanleyB.Zdonik	AnjaliJhingran	1
PhilipS.Yu	KeWang	5
JeffPollock	AlonY.Halevy	1
WeiWang0009	PengWang	1
TakahiroKosaka	ShinjiShimojo	1
XuedongChen	MiguelFerreira	1
NicholasLester	JustinZobel	1
ShigeoSugimoto	HiroyukiKitagawa	1
XinLunaDong	AlonY.Halevy	1
ShiyingHuang	GeoffreyI.Webb	2
PhilipA.Bernstein	HolgerMeyer	2
RachelPottinger	AngelaBonifati	1
XiaohuaZhou	AnnPrestrud	1
OktieHassanzadeh	MohammadGhodsi	1
MasaoSakata	DaisukeSaitoh	1
HongboFu	DanHong	1
ThomasR.Gabriel	MichaelR.Berthold	1
MinghuaZhang	KevinY.Yip	1
JianZhai	DimitrisPapadias	1
VanjaJosifovski	EugeneJ.Shekita	1
MarcoCristo	EdwardA.Fox	1
YongZhao	MichaelWilde	1
RaghuMachiraju	HuiYang	1
SarvjeetSingh	ReynoldCheng	1
YaqinWang	BeijunRuan	1
RutSiguroardottir	HlynurHauksson	1
RichardHull	MosheY.Vardi	1
Kai-UweSattler	ChristianvonderWeth	1
VictorTeixeiradeAlmeida	MarkusSpiekermann	1
SabineMassmann	HongHaiDo	1
HoaNguyen	AnHaiDoan	1
QiangYang	JunYan	1
RameshGovindan	HuiZhang0002	1
ZhengChen	YimingYang	1
TonyPan	KunHuang	1
NguyenAnhTuan	LeHoaiBac	1
OliverSeeliger	AdrianBaras	1
QiangYang	JieYin	2
GrahamJ.Williams	AdaWai-CheeFu	1
KeWang	AdaWai-CheeFu	2
MichaelFassino	LianYan	1
SurongWang	ManoranjanDash	1
GarrickStaples	CarlKesselman	1
KennethS*rensen	ArthurLim*re	1
ReijiTeramoto	KentaroWakatsuki	1
TerrenceMason	RamonLawrence	1
MariaSalam*	JamesReilly	1
LiangzhongYin	GuohongCao	1
NikoBeerenwinkel	MarkOette	1
XiaohuaHu	Il-YeolSong	2
SurongWang	Liang-TienChia	1
SundarSaiprasad	Fatma*zcan	1
ThomasTakeoOsugi	KunDeng	1
WolfgangNejdl	J*rgDiederich	1
TakeshiYamada	SatoshiNakamura	1
MohamedH.Ali	IbrahimKamel	1
Tat-SangChoy	HuiYang	1
WeiWang0009	JianXu	1
SebastianMichel	ChristianZimmer	1
VipinGupta	EwaDeelman	1
ShashiShekhar	PushengZhang	1
ThomasLengauer	J*rgenK.Rockstroh	1
ZhiminChen	VivekR.Narasayya	1
LeiLiu	JiongYang	1
IlujuKiringa	AnastasiosKementsietsidis	1
MargaretH.Dunham	LinLu	1
JasmineNovak	AndrewTomkins	2
RobertMcCann	AnHaiDoan	2
XueqingGong	WeiningQian	1
SungMinBae	JiYoungWoo	1
RossSparks	JiuyongLi	1
QiGuo	HangGuo	1
SabineRabas*da	OmarBoussaid	1
ZhihongChong	JeffreyXuYu	1
XiaojunWan	JianfengGao	1
ShirohHoribe	HideoItoh	1
Ming-SyanChen	ChienChinChen	1
MichailVlachos	DimitriosGunopulos	1
TetsujiSatoh	HidetoshiKido	1
TakashiTomii	MasaruUeda	1
GerdF*tkenheuer	DanielHoffmann	1
VipinGupta	ThomasA.Russ	1
ShanLei	JianzhongSun	1
MatthewMichelson	ClaudeNanjo	1
HolgerSchwarz	ChristophMangold	1
XiaohuaHu	RobertB.Allen	1
RobertMann	PeterBuneman	1
StanleyB.Zdonik	AnuragMaskey	1
MaureenDougherty	EwaDeelman	1
ThomasLengauer	RolfKaiser	1
RyanRich	DouglasHolt	1
Xue-QiangZeng	Jian-YunNie	1
SvenHelmer	Carl-ChristianKanne	1
AnilK.Jain	AlexanderP.Topchy	1
VijayshankarRaman	PeterJ.Haas	1
JohnWilkins	HuiYang	1
SivasankaranChandrasekar	DanielaFlorescu	1
YuXu	YannisPapakonstantinou	1
EdmondLau	AlexRasin	1
ToshiakiFujii	MasatoKoyamaishi	1
R.BharatRao	GlennFung	3
MarkA.Hall	EibeFrank	1
ShobhitMathur	ChristopherR*	1
NicolaLeone	MaurizioLenzerini	1
QiangWang	LonginJanLatecki	2
Wolf-TiloBalke	WolfSiberski	1
YukiyoTakasago	YoshinoriSakai	1
ArnonRosenthal	AnHaiDoan	1
MasaoSakata	AtsunobuKaminuma	1
ZujiaXu	BillP.Buckles	1
YuchangGong	ChuangWang	1
PhilipA.Bernstein	PaoloCappellari	1
ThuHo*ng	RichardD.DeVeaux	1
TsutomuFujiwara	ShunsukeUemura	1
PohsanLai	LiLin	1
KazuoHiyane	HiroshiInujima	1
Ren*eJ.Miller	LeiJiang	1
ShannonHastings	JoelH.Saltz	1
ZhenHuaLiu	SivasankaranChandrasekar	1
YanifAhmad	OlgaPapaemmanouil	1
AnuragMaskey	AnjaliJhingran	1
VilasWuwongse	PongtawatChippimolchai	1
TakeshiYamada	ChiyomiMiyajima	1
FrancescoBonchi	DinoPedreschi	2
MarcusFontoura	EugeneJ.Shekita	2
H.V.Jagadish	BengChinOoi	1
PhilipMaechling	MaureenDougherty	1
MotomichiToyama	DaeilPark	1
VictorVianu	MonicaMarcus	1
NormenSeemann	KevinS.Beyer	1
YiHuang	MatthiasSchubert	1
SongtingChen	ElkeA.Rundensteiner	1
K.K.Loo	BenKao	1
XiaoyangTan	SongcanChen	1
KellyPalmer	*zg*rSimsek	1
XueminLin	WeiWang0011	4
MonicaMarcus	LiyingSui	1
NgaTran	AlexRasin	1
XuanhuiWang	TaoTao	1
YuXu	HamidPirahesh	1
VikasArora	SivasankaranChandrasekar	1
SamuelEdoho-Eket	EdoardoAiroldi	1
RobertC.James	JieGao	1
JormaBoberg	EvgeniTsivtsivadze	1
ZhaoHuiTang	HangLi	1
ZhiweiLi	LieLu	1
TharamS.Dillon	OmarKhadeerHussain	1
RaviKumar	D.Sivakumar	2
TokWangLing	Mong-LiLee	1
YingXing	Ugur*etintemel	1
Jos*A.Blakeley	BalajiRathakrishnan	1
JunyiXie	HaiYu	1
MuLi	BinggongDing	1
XiangZhang	MouradOuzzani	1
Shen-TatGoh	PanosKalnis	1
StefanieRinderle	PeterDadam	1
FlipKorn	DiveshSrivastava	2
WeiyiMeng	HaiHe	1
PhilipS.Yu	Ming-JyhHsieh	1
LucianoA.Digiampietri	Andr*Santanch*	1
YunBai	YuhuiQiu	1
WeiHong	CyrusShahabi	1
ThomasEiter	DomenicoLembo	1
JaideepSrivastava	ColinDeLong	1
KristinTufte	JinLi	2
DanielGruhl	AndrewTomkins	1
JunyiXie	HaoHe	1
PrakashLinga	JohannesGehrke	1
SihemAmer-Yahia	LaksV.S.Lakshmanan	1
RyoTaguchi	HaruoYokota	2
JuhoMuhonen	BartGoethals	1
KevinS.Beyer	EugeneJ.Shekita	1
BradleyBerg	AnuragMaskey	1
RichardT.Snodgrass	ChristianS.Jensen	2
WeiPeng	ShengMa	2
W.BretChurch	SanjayChawla	1
KenC.K.Lee	HongVaLeong	1
Rog*riodeLemos	CliffB.Jones	1
GeorgeLapis	BrianVickery	1
Marie-ClaudeGaudel	AlanFekete	1
JeffreyF.Naughton	DavidJ.DeWitt	1
YunZhou	W.BruceCroft	1
Mar*aA.Nieto-Santisteban	DavidJ.DeWitt	1
ToshinariIida	AtsuyukiMorishima	1
ChendongZou	BettySalzberg	1
YannisPetrakis	EvaggeliaPitoura	1
VolkerMarkl	AlbertoLerner	1
ToshiakiOkawara	Jun'ichiTanaka	2
YingChen	QiangYang	1
XiaotongShen	SijinLiu	1
WenxinLiang	KazuhitoKobayashi	1
Woo-CheolKim	JeeheeYoon	1
StephenLangella	MatheusRibeiro	1
XingXie	Wei-YingMa	1
PaulH.Leng	LuZhang	1
RichardT.Snodgrass	AndreasHeuer	2
MichaelDittenbach	AndreasRauber	1
MasaoSakata	HiroshiSaruwatari	1
LimsoonWong	LiLin	1
JosephP.Kenny	BrettW.Bader	1
SergeAbiteboul	MichaelA.Harrison	1
SmritiYamini	AmarnathGupta	1
MaartendeRijke	MaartenMarx	2
LiefengBo	LichengJiao	1
MichaelJ.Carey	JiaweiHan	1
SutanuChakraborti	RobertLothian	1
RamakrishnanSrikant	RakeshAgrawal	1
MariaPratt	BobThome	1
SteveBridges	PeterHaider	1
ThomasEiter	NicolaLeone	1
PeterJ.Haas	NimrodMegiddo	1
XinZheng	Wei-YingMa	1
MasaoSakata	KiyohiroShikano	1
XiangZhang	SusanneE.Hambrusch	1
JoeMcCloskey	EdGreengrass	1
CarlosSa*udo	AntonioBahamonde	1
TetsuyaIkeda	HideoItoh	1
ToreRisch	CarmenCostilla	1
TaketoshiUshiama	NaotoMukai	1
UlrichTelle	DirkAnsorge	1
StanleyB.Zdonik	OlgaPapaemmanouil	1
XinXu	Kian-LeeTan	1
V*ctorRobles	Mar*aS.P*rez	1
WeiHan	VijayshankarRaman	3
KeWang	BenjaminC.M.Fung	2
RolfSchimpfky	PeterHaider	1
XavierBonnaire	Mar*a-CristinaRiff	1
SergioStorari	GiacomoGamberoni	1
SusanKotsovolos	RaviMurthy	1
MariosHadjieleftheriou	DimitrisPapadias	2
NicolaLeone	GiovambattistaIanni	1
RobertaCochrane	BertVanderLinden	1
ShashankPandit	HrishikeshKarambelkar	1
WeiFan	PhilipS.Yu	2
VanjaJosifovski	NormenSeemann	1
Hans-PeterKriegel	ChristianB*hm	1
ZhihuaZhang	HuiZhang	1
ShankarPal	DenisChurin	1
TapioSalakoski	AleksandrMyll*ri	1
RajasekarKrishnamurthy	JeffreyF.Naughton	1
MaddalenaGarzetti	IlujuKiringa	1
ShankarPal	OliverSeeliger	1
AhmetCosar	AdnanYazici	1
MokhtarKandil	IvanPopivanov	1
V*ctorRobles	ErnestinaMenasalvasRuiz	1
DeepaParanjpe	ByronDom	1
JieChen	DamienMcAullay	1
ErikBuchmann	ChristianvonderWeth	1
JanVandenBussche	BartGoethals	1
AlexandrosKalousis	AdamWoznica	1
MarianoP.Consens	DenilsonBarbosa	1
UpendraSharma	SugataGhosal	1
ChuanLi	ChangjieTang	1
SunilPrabhakar	ElisaBertino	1
ShusakuTsumoto	HidenaoAbe	1
SunilPrabhakar	AnnChristineCatlin	1
RichardButterworth	DanA.Simovici	1
RiccardoRosati	GiovambattistaIanni	1
YiqiuHan	WaiLam	1
XinqiangZuo	XiaomingJin	1
FlorianHaftmann	DonaldKossmann	1
TaneliMielik*inen	AristidesGionis	1
WeiYu	GideonSchaller	1
YoshioMomouchi	HiroshiEchizen-ya	1
MichaelDittenbach	GeorgP*lzlbauer	1
WalidG.Aref	AnnChristineCatlin	1
PhilipS.Yu	CharuC.Aggarwal	3
ZsoltTivadarKardkov*cs	DomonkosTikk	1
JiaweiHan	JianPei	1
Fu-LaiChung	Chak-manNg	1
WingSingWong	DikLunLee	1
LucianoA.Digiampietri	GilbertoZontaPastorelloJr.	1
MichaelR.Genesereth	Lee-MingZen	1
KentaroWakatsuki	HideoMatsuda	1
ChenLi	AnthonyK.H.Tung	1
HuidongJin	HongxingHe	1
VincentShin-MuTseng	Chao-HuiLee	1
ErnestinaMenasalvasRuiz	*scarCubo	1
TetsuyaIshie	TakashiTomii	1
JaideepVaidya	BrettBanich	1
RameshGovindan	CyrusShahabi	2
EamonnJ.Keogh	DimitriosGunopulos	1
YoTakano	KojiIwanuma	1
JanezDemsar	AleksJakulin	1
VadirajaBhatt	SrikanthSampath	1
MarekWojciechowski	MaciejZakrzewicz	1
SourashisRoy	ChristopherOlston	1
BarbaraCatania	AnnaMaddalena	1
DavidB.Lomet	CliffB.Jones	1
ShengZhong	RebeccaN.Wright	2
PhilipS.Yu	HongjunLu	2
AkihikoKonagaya	AkiHasegawa	1
TaoTao	AliPinar	1
Jos*AmbrosioToval*lvarez	FernandoMolina	1
ToonCalders	BartGoethals	1
ElisaBertino	ArifGhafoor	1
SimonKamenkovich	AnatEyal	1
SuminSong	KevinChen-ChuanChang	1
QunxiaLi	HaifengShen	1
SaileshKrishnamurthy	AnilEdakkunni	1
JunghooCho	ChristopherOlston	1
CarlottaDomeniconi	BojunYan	1
Yi-HungWu	ArbeeL.P.Chen	3
JordiTurmo	AliciaAgeno	1
LeonardPitt	CindaHeeren	1
Pierre-AlainLaur	PascalPoncelet	1
ZhengLiu	JeffreyXuYu	1
RolfKaiser	FrancescaCeccherini-Silberstein	1
WalidA.Najjar	DemetriosZeinalipour-Yazti	1
TsuyokiNishikawa	KatsuyukiSawai	1
DanielKeren	AmirBar-Or	1
SteveBridges	DavidS.Vogel	1
HongSu	ElkeA.Rundensteiner	1
LucianoA.Digiampietri	ClaudiaBauzerMedeiros	1
MichaelWilde	LucMoreau	1
SeonHoKim	RogerZimmermann	1
KarstenDraba	JensBleiholder	1
JuanRobles	EstherDopazo	1
SeanCox	BehrokhSamadi	1
NickKoudas	FlipKorn	1
JohannesF*rnkranz	EykeH*llermeier	1
ThomasSeidl	MohammedJaveedZaki	1
YiLin	MartaPati*o-Mart*nez	1
BrianNeilLevine	AndrewFast	1
SusumuDate	HideoMatsuda	1
GiladMishne	AlexeyRoytman	1
ChristosFaloutsos	ArnabBhattacharya	1
SharadMehrotra	HakanHacig*m*s	1
YiLuo	QingLi	1
Ren*eJ.Miller	PatriciaRodr*guez-Gianolli	1
ThorstenJoachims	FilipRadlinski	1
OlfaNasraoui	MyraSpiliopoulou	1
MinhLy	DanielR.Jeske	1
RolandOrre	G.NiklasNor*n	1
NorihideKitaoka	MasakiyoFujimoto	1
RobertAtlas	BilahariAkkiraju	1
SoumenChakrabarti	S.Sudarshan	1
WalidG.Aref	MohamedF.Mokbel	2
Jos*M.Pe*aS*nchez	*scarCubo	1
KlausKorn	GerdF*tkenheuer	1
LeoYungHangLau	AdaWai-CheeFu	1
HuidongJin	DamienMcAullay	1
Kai-UweSattler	ErikBuchmann	1
JayavelShanmugasundaram	GerhardWeikum	1
PhilipMaechling	BrianMendenhall	1
HongjunLu	GabrielPuiCheongFung	2
AlexanderTuzhilin	AdaWai-CheeFu	1
JeremyKubica	AndrewW.Moore	1
XiaCao	ShuaiChengLi	1
Jeong-HyonHwang	AnjaliJhingran	1
ZunpingCheng	BeijunRuan	1
ElenaMonta**s	El*asF.Combarro	1
SouravS.Bhowmick	QiankunZhao	3
JureLeskovec	DeepayanChakrabarti	1
LathaS.Colby	Fatma*zcan	1
Min-OkJung	Byung-KyuKim	1
Rog*riodeLemos	RaviRajwar	1
SusanneE.Hambrusch	ChristopherW.Clifton	1
Wang-ChienLee	DikLunLee	2
YidongYuan	HongjunLu	1
PinarSenkul	AsumanDogac	1
KazuhitoKobayashi	DaiKobayashi	1
QingZhang	Mong-LiLee	1
StevenGreco	RobertAtlas	1
MaurizioLenzerini	GiovambattistaIanni	1
Jun'ichiTanaka	AtsuyukiMorishima	2
MassimoMecella	GiuseppeDeGiacomo	1
ShravanChamakura	SharmaChakravarthy	1
ViswanathanKrishnamurthy	MuralidharKrishnaprasad	1
XiaochenWu	PengWang	1
GiorgioTerracina	GianluigiGreco	1
MaddalenaGarzetti	LeiJiang	1
Ghazi-NourdineBenadjaoud	FrancisPang	1
MarcosAndr*Gon*alves	BaopingZhang	2
MarcoRuzzi	GiorgioTerracina	1
IsidroRamos	ArturBoronat	1
KaranVahi	GurmeetSingh	1
MasashiYamamuro	MakotoOnizuka	1
ViswanathanKrishnamurthy	EricSedlar	1
ShengHuang	AoyingZhou	1
PeterBruza	Jian-YunNie	1
SteveB.Jiang	BettySalzberg	1
SoumenChakrabarti	ShashankPandit	1
SanjayAgrawal	ManojSyamala	1
YuriBreitbart	FuatAkal	1
AmrElAbbadi	AmbujK.Singh	1
KlausKorn	DanielHoffmann	1
SihemAmer-Yahia	DiveshSrivastava	2
TomM.Mitchell	RaduStefanNiculescu	1
ThaiQuangTung	Dae-WonKim	1
YongguangJiang	JianjunHu	1
MartinD*umer	KlausKorn	1
SooyoungYoo	HeekyongPark	1
XiaohuiYu	CalistoZuzarte	1
NipunAgarwal	MuralidharKrishnaprasad	1
RobertaCochrane	GuyM.Lohman	1
FernandoJ.Corbacho	BeatrizS*nchez	1
KrithiRamamritham	Kian-LeeTan	1
ChristopherR*	BhushanMandhani	1
MariosHadjieleftheriou	KyriakosMouratidis	1
VladislavShkapenyuk	OliverSpatscheck	1
ZhenHuaLiu	Anh-TuanTran	1
XiaolingWang	WenQiangWang	1
TapioPahikkala	EvgeniTsivtsivadze	1
VincenzinoLio	BartoszNowicki	1
PushengZhang	JinSoungYoo	1
HuiZhang0002	GianlucaIannaccone	1
ShahabKamali	OktieHassanzadeh	1
TaoJia	HongyeSu	1
Wei-YingMa	MuyuanWang	1
LinQiao	BalakrishnaR.Iyer	2
JiepingYe	ChrisH.Q.Ding	1
PaulBird	JerryKiernan	1
Wen-SyanLi	InderpalNarang	2
RaviRajwar	AlanFekete	1
Lu*sRodrigues	BrianRandell	1
GurmeetSingh	GarrickStaples	1
HiroshiSaruwatari	AtsunobuKaminuma	1
RobertMcCann	AlexanderKramnik	1
IanC.MacMillan	DanielFleder	1
YingboMiao	VladoKeselj	1
SridharVaradarajan	AparnaNagargadde	1
XuanHieuPhan	TuBaoHo	1
RonaldFagin	JasmineNovak	1
Mar*aA.Nieto-Santisteban	JimGray	1
WeiJiang	BrettBanich	1
GregoryC.Sharp	DavidR.Kaeli	1
SrinathShankar	DavidJ.DeWitt	1
AsavinMeengen	AritThammano	1
DeepayanChakrabarti	ChristosFaloutsos	3
ChunyanWang	AnthonyLo	1
KristenLeFevre	DavidJ.DeWitt	1
TakamichiMiyata	KatsunoriYamaoka	1
WitoldStaniszkis	GeorgGottlob	1
ShengnanCong	JiaweiHan	1
PhilipA.Bernstein	AlonY.Halevy	2
WeiHong	HuiZhang0002	1
MasaakiTanizaki	KishikoMaruyama	1
M.ErdemKurul	AmarnathGupta	2
VictorM.Markowitz	NikosKyrpides	1
PhilipS.Yu	OsmarR.Za*ane	1
ZhuoChen	TokWangLing	1
XiaoyongLiu	W.BruceCroft	1
RameshGovindan	GianlucaIannaccone	1
SteveBarr	SameepMehta	1
TetsuyaIkeda	ShirohHoribe	1
RichardHull	DiegoCalvanese	1
HakanFerhatosmanoglu	AliPinar	1
OsmarR.Za*ane	BamshadMobasher	1
XuedongChen	NgaTran	1
PhilipS.Yu	Kun-LungWu	2
Jian-WeiLiu	Jia-JinLe	2
VijayshankarRaman	K.Sel*ukCandan	1
MarianaJbantova	BinLiu	2
ScottOster	JoelH.Saltz	1
K.Sel*ukCandan	ArsanySawires	1
AsumanDogac	AhmetCosar	1
RicardodaSilvaTorres	EvandroBacarin	1
YoshinoriSakai	TakamichiMiyata	1
NesimeTatbul	AnjaliJhingran	1
NazimH.Madhavji	CharlesX.Ling	1
JenniferNeville	*zg*rSimsek	1
YanifAhmad	NesimeTatbul	1
Jung-ImWon	JeeheeYoon	2
MarcelinoPereiradosSantosSilva	GilbertoC*mara	1
ZhimingDing	ThomasH*se	1
GilbertoZontaPastorelloJr.	EvandroBacarin	1
GurmeetSingh	EwaDeelman	1
VassilisAthitsos	StanSclaroff	1
ZahirBalaporia	ChrisClifton	1
XueLi	XingzhiSun	1
JeffreyF.Naughton	GangLuo	1
RaviMurthy	Anh-TuanTran	1
SukhoLee	DongseopKwon	1
KaranVahi	CarlKesselman	1
MinSong	Il-YeolSong	2
ShawnR.Jeffery	SaileshKrishnamurthy	1
WenxinLiang	AkitsuguWatanabe	1
Jeng-KuenChiu	Ee-PengLim	1
P*velCalado	AlexandreX.Falc*o	1
LinCheung	BenKao	1
ArnoSiebes	A.J.Feelders	1
MatthewHurst	KamalNigam	1
JulianaFreire	AlbertoO.Mendelzon	1
JensBleiholder	FelixNaumann	1
HaukeWalter	GerdF*tkenheuer	1
Tat-SangChoy	JohnWilkins	1
YuXia0003	JimingPeng	1
M*rioJ.Silva	BrunoMartins	1
JimGray	DavidJ.DeWitt	1
YaserS.Abu-Mostafa	Hsuan-TienLin	1
Woon-HakKang	Dong-HyunKim	1
RichardHull	MassimoMecella	1
GeorgeLapis	ChunZhang	1
JianXu	BaileShi	1
JasmineNovak	D.Sivakumar	1
GrahamJ.Williams	ChrisKelman	1
KenBarker	ChunyanWang	1
VictorM.Markowitz	FrankKorzeniewski	1
MoustafaGhanem	BinWang	1
Jung-HwanOh	JeongKyuLee	1
YogeshSimmhan	DennisGannon	1
YoshikiNinomiya	TakeoKato	1
Mih*lyJakob	DanielaNicklas	2
TonyGriffiths	KeithT.Mason	1
WeiPeng	FengLiang	1
ThomasH*se	ThomasBehr	1
MartinPfeifle	Hans-PeterKriegel	5
TonjeStrommenSteigedal	RuneS*tre	1
Chotirat(Ann)Ratanamahatana	AnthonyJ.Bagnall	1
MarioA.Nascimento	AlexandruComan	2
WojciechSzpankowski	MikhailJ.Atallah	1
JiaweiHan	HwanjoYu	1
TetsuyaIkeda	HiroshiTakegawa	1
ZhiweiLi	NaiyaoZhang	1
PereAlbert*	JuanJos*delCoz	1
MichaelWatzke	CurtJ.Ellmann	1
MichaelE.Houle	JunSakuma	1
LathaS.Colby	HamidPirahesh	1
XiaolingWang	BengChinOoi	1
ShigeoSugimoto	AtsuyukiMorishima	2
RicardodaSilvaTorres	BaopingZhang	1
MartinMichalowski	CraigA.Knoblock	1
ShiminChen	PhillipB.Gibbons	1
StefanoVolinia	EvelinaLamma	1
RongShe	PhilipS.Yu	2
PeterR.Pietzuch	JeffreyShneidman	1
UtkarshSrivastava	MarcelKutsch	1
M.Tamer*zsu	ElisaBertino	1
XiaoguangLi	DalingWang	1
SrinivasanParthasarathy	JohnWilkins	1
MatthiasRenz	Hans-PeterKriegel	3
ShariqRizvi	LinusLiang	1
WalidG.Aref	SunilPrabhakar	1
JamesAllan	BenCarterette	1
ElizabethJ.O'Neil	DanielJ.Abadi	1
ChristopherW.Clifton	ArifGhafoor	1
WeiguoFan	BaopingZhang	2
Zhi-HongDeng	Shi-WeiTang	1
GideonSchaller	DenisChurin	1
XiaoliZhangFern	MarkA.Friedl	1
RicardoJim*nez-Peris	BettinaKemme	1
Kian-LeeTan	CheeYongChan	2
MasaoSakata	AkinobuLee	1
YongXiaojia	ChangjieTang	1
OlfaNasraoui	CarlosRojas	1
JieTang	HangLi	1
Md.Altaf-Ul-Amin	KenKurokawa	1
NesimeTatbul	MarkHumphrey	1
Wing-KaiHon	MouradOuzzani	1
RolfSchimpfky	DavidS.Vogel	1
FangXiong	DyceJingZhao	1
AtsunobuKaminuma	AkinobuLee	1
M.Tamer*zsu	GordonB.Agnew	1
ZografoulaVagena	PhilipS.Yu	2
HaukeWalter	FrancescaCeccherini-Silberstein	1
WataruNakano	HaruoYokota	1
JayantMadhavan	AnHaiDoan	1
TobiasScheffer	SzymonJaroszewicz	1
ThomasB*ck	AdriaanP.IJzerman	1
GaoCong	AnthonyK.H.Tung	1
YangDu	EvangelosKanoulas	1
ChunyanMiao	AngelaGoh	1
KenBarker	AnthonyLo	1
StevenM.Beitzel	AleksanderKolcz	1
RichardHull	JianwenSu	1
WeiguoFan	FernandoA.DasNeves	2
TokWangLing	EnhuaJiao	1
RobertMann	ByronChoi	1
PanosVassiliadis	AlkisSimitsis	1
SunilPrabhakar	RahulShah	1
R*gisGras	HenriBriand	1
Ming-SyanChen	MengChangChen	1
YifengZheng	SusanB.Davidson	1
GeorgeLapis	BertVanderLinden	1
MuratDundar	JinboBi	1
RichardHull	DanielaBerardi	1
CristinaConde	*ngelSerrano	1
YasuhikoFujisaki	TakamichiMiyata	1
JinhuiYuan	BoZhang	1
NaokiAmma	K.M.AzharulHasan	1
PeterJ.Haas	GuyM.Lohman	1
Marie-ChristineRousset	HiroshiMotoda	1
VolkerTresp	ShipengYu	2
KeWang	JianyongWang	1
JaapKamps	B*rkurSigurbj*rnsson	1
TaeSikHan	PrasenjitMitra	1
DamienMcAullay	ChrisKelman	1
Yen-KuangChen	AmolGhoting	1
LinaPeng	K.Sel*ukCandan	1
JimGray	DavidT.Liu	1
Wing-KaiHon	AhmedK.Elmagarmid	1
JayavelShanmugasundaram	AdinaCrainiceanu	1
TerranLane	ShibinQiu	1
SharmaChakravarthy	RamanAdaikkalavan	2
RobertA.Stine	LyleH.Ungar	1
XinZheng	QianShengCheng	1
SooyoungYoo	JonghoonChun	1
HannuToivonen	BartGoethals	1
OmarKhadeerHussain	ElizabethChang	1
RossSparks	ChrisKelman	1
ViswanathanKrishnamurthy	SivasankaranChandrasekar	1
PhilipS.Yu	OlfaNasraoui	1
LaksV.S.Lakshmanan	GaneshRamesh	1
HiroshiTakegawa	HirokoMano	1
MarikoHatakeyama	AkiHasegawa	1
JingBai	GuihongCao	1
Woo-CheolKim	SanghyunPark	1
YoshinariKanamori	SayakaImai	1
MichaelJ.Franklin	LinusLiang	1
ZhaogongZhang	JingGao	1
WalidG.Aref	SusanneE.Hambrusch	1
JianwenSu	BinLin	1
WojciechStach	RafalRak	1
YixinChen	HuiminChen	1
SumanNath	PhillipB.Gibbons	1
NoraSpeer	ChristianSpieth	1
VanjaJosifovski	HamidPirahesh	1
YiLi	StellaLuk	1
WilliamH.Milnor	AmitP.Sheth	1
PanosK.Chrysanthis	MitchCherniack	1
AlanS.Abrahams	AdrianBecker	1
SouravS.Bhowmick	Liang-TienChia	1
YuQian	KangZhang	1
PatrickE.O'Neil	MichaelStonebraker	1
RachelPottinger	JunYang	1
MichaelRys	DenisChurin	1
RebeccaN.Wright	GeethaJagannathan	1
RolfKaiser	DanielHoffmann	1
XuequnShang	Kai-UweSattler	1
StephenJ.Maybank	DachengTao	1
TakeshiYamada	AkiraSasou	1
RushiDesai	HrishikeshKarambelkar	1
OlgaPapaemmanouil	BradleyBerg	1
TongLuo	DmitryB.Goldgof	1
EricC.Jensen	DavidD.Lewis	1
YizhouWang	DouglasStottParkerJr.	1
ZhuoChen	GillianDobbie	1
NaokiAmma	MasayukiKuroda	1
KeunHoRyu	JeongHeeHwang	1
StanSclaroff	MariosHadjieleftheriou	1
HaixunWang	Chang-ShingPerng	1
ShinjiShimojo	KazutoYamazaki	1
JihieKim	GarrickStaples	1
NarainH.Gehani	DimitriTheodoratos	1
MorHarchol-Balter	AnastassiaAilamaki	1
WillyZwaenepoel	CristianaAmza	1
TakahiroKosaka	ReijiTeramoto	1
AlpaSachde	AkshayaArora	1
TobiasScheffer	SteffenBickel	1
KevinS.Beyer	JimKleewein	1
TakashiTomokiyo	MatthewSiegler	1
YujiMatsumoto	MasashiShimbo	1
YasuhikoFujisaki	KatsunoriYamaoka	1
XiaofengHe	ChrisH.Q.Ding	2
VictorVianu	SheilaA.Greibach	1
HongjunLu	HaifengJiang	1
Ming-TingSun	Ching-YungLin	1
StevenGreco	BilahariAkkiraju	1
XindongWu	DachengTao	1
JamesBailey	GuozhuDong	1
M.Tamer*zsu	JieLian	1
RaviRajwar	DavidB.Lomet	1
MiguelFerreira	MichaelStonebraker	1
ChrisJermaine	AlinDobra	2
ThienNguyen	JishengLiang	1
Ghazi-NourdineBenadjaoud	AnupamSingh	1
YufeiTao	JianZhai	1
Shin'ichiWakabayashi	NoriyoshiYoshida	1
YahyaSlimani	JihemRezgui	1
MohamedA.Soliman	ChengkaiLi	1
PatrickE.O'Neil	MiguelFerreira	1
TokWangLing	GillianDobbie	1
PhilipMaechling	HansChalupsky	1
YaserS.Abu-Mostafa	LingLi	1
JasmineNovak	DanielGruhl	1
YasuyukiShirai	KazuoHiyane	1
WolfgangLehner	ThomasLegler	1
ThomasEiter	GeorgGottlob	1
MartinMozina	BlazZupan	1
KenroAihara	JunAdachi	1
JanD.Gehrke	IngoJ.Timm	1
MichalisVazirgiannis	GerhardWeikum	1
ChiyomiMiyajima	AkiraSasou	1
DavidB.Lomet	AlexanderB.Romanovsky	1
KristinTufte	DavidMaier	2
ToshikiEndo	MasakiyoFujimoto	1
TimothyMalkemus	SriramPadmanabhan	1
ShannonHastings	MatheusRibeiro	1
SridharGullapalli	GarrickStaples	1
XiangLi	RahulRamachandran	1
GeorgeEadon	EugeneInseokChong	1
JanChomicki	CalistoZuzarte	1
RyanRich	RuiXiao	1
XiaokuiXiao	WangKayNgai	1
Yen-KuangChen	SrinivasanParthasarathy	1
WillyZwaenepoel	AlanL.Cox	1
BrunoP*ssas	BerthierA.Ribeiro-Neto	2
HansChalupsky	GarrickStaples	1
TorstenGrust	PeterA.Boncz	1
RobertJedicke	AndrewW.Moore	1
DanielHoffmann	Carlo-FedericoPerno	1
PeterR.Pietzuch	MargoI.Seltzer	1
MarcoRuzzi	GianluigiGreco	1
LanYe	DanielR.Jeske	1
VikasArora	AnandManikutty	1
NivioZiviani	BrunoP*ssas	2
YoshioMomouchi	KenjiAraki	1
SurajitChaudhuri	RaghavKaushik	1
ToyohideWatanabe	TaketoshiUshiama	1
NathanFolkert	AndrewWitkowski	1
UlrichTelle	MarkusSpiekermann	1
YunhuaHu	ShenjieLi	1
WeiWang0010	LeonardMcMillan	1
KeishiTajima	HidetakaMatsumura	1
TilmanLange	JoachimM.Buhmann	1
WenshengWu	ClementT.Yu	1
S.Muthukrishnan	FlipKorn	1
Ugur*etintemel	OlgaPapaemmanouil	2
ReijiTeramoto	KazutoYamazaki	1
TyroneGrandison	PaulBird	1
JiongYang	FengPan	1
RuiXiao	DanielR.Jeske	1
ThomasH*se	RalfHartmutG*ting	1
DivyakantAgrawal	AmrElAbbadi	6
ZhaoqiChen	SharadMehrotra	1
RaviSundaram	RaviKumar	1
ThomasSeidl	NicoleSchneider	1
R*gisGras	JulienBlanchard	1
VipinGupta	GaurangMehta	1
MattWelsh	MargoI.Seltzer	1
RahulRamachandran	BilahariAkkiraju	1
TakuyaHiraoka	HideoItoh	1
RaghuMachiraju	JohnWilkins	1
PilarHerrero	*scarCubo	1
MichailVlachos	Jian-WeiLiu	1
KyriakosMouratidis	DimitrisPapadias	1
SeanCox	RuiXiao	1
WeiZhao	ShengquanWang	1
PeterJ.Haas	ChunZhang	1
YolandaGil	VipinGupta	1
PeterM.G.Apers	DjoerdHiemstra	1
HweeHwaPang	ArpitJain	1
PeterA.Tucker	DavidMaier	2
AnnChristineCatlin	AhmedK.Elmagarmid	1
YuguoChen	JunyiXie	1
VipinKumar	HuiXiong	1
YojiTaniguchi	NobutoshiSagawa	1
TuongC.Truong	GeorgeLapis	1
PengZhang	NorbertRiedel	1
ElisaBertino	AnnChristineCatlin	1
GautamDas	AristidesGionis	1
KarlAberer	AnwitamanDatta	2
ShawnR.Jeffery	MichaelJ.Franklin	1
RicardoCartaxoModestodeSouza	DaltonM.Valeriano	1
MarzenaKryszkiewicz	KatarzynaCichon	1
Ren*eJ.Miller	IlujuKiringa	1
TahsinM.Kur*	MatheusRibeiro	1
ShusakuTsumoto	MihoOhsaki	1
Xiang-YangLi	PhilipS.Yu	1
RameshGovindan	RamakrishnaGummadi	1
OliverSeeliger	BrandonBerg	1
MihaGrcar	DunjaMladenic	1
LeiSheng	AndrewWitkowski	2
ScottOster	MatheusRibeiro	1
RobertoAcerbis	MarcoBrambilla	1
MichaelFink	EdytaKalka	1
RaviMurthy	MuralidharKrishnaprasad	1
Jos*Iborra	AbelG*mez	1
NikosMamoulis	MariosHadjieleftheriou	1
TatsuoTsuji	KenHiguchi	2
OdedShmueli	DavidKonopnicki	1
YanifAhmad	MarkHumphrey	1
JianxinYao	GengfengWu	1
XiaofangZhou	JiyuanAn	1
WenJin	JiaweiHan	1
SoumenChakrabarti	SandeepPandey	1
WangKayNgai	BenKao	1
M.Tamer*zsu	JenniferWidom	1
YoshinoriSakai	AkiKobayashi	2
RolfKaiser	KlausKorn	1
TakeoKato	MinekiSoga	1
SouripriyaDas	EugeneInseokChong	1
SpirosPapadimitriou	PanayiotisTsaparas	2
TuongC.Truong	NormenSeemann	1
Jun'ichiTatemura	DivyakantAgrawal	1
MichaelStonebraker	AlexRasin	2
MichaelWatzke	GangLuo	1
WynneHsu	Mong-LiLee	4
IsmailHakkiToroslu	AhmetCosar	1
PatriciaRodr*guez-Gianolli	JohnMylopoulos	1
TakehiroFurudate	KentaroWakatsuki	1
K.Sel*ukCandan	Jun'ichiTatemura	1
YanifAhmad	Ugur*etintemel	2
RohiniK.Srihari	AnmolBhasin	1
WolfgangNejdl	WolfSiberski	1
RichardR.Muntz	HaixunWang	1
RaymondT.Ng	LaksV.S.Lakshmanan	2
Ji-HoonKang	Byung-KyuKim	1
DiveshSrivastava	DavidToman	1
VassilisJ.Tsotras	PetkoBakalov	1
Paul-AlexandruChirita	J*rgDiederich	1
ShawnR.Jeffery	LinusLiang	1
TuanNamTran	KenjiSatou	1
ValentinaSvicher	DanielHoffmann	1
YangyongZhu	Fang-zhongSu	1
KanghengWu	Jian-TaoSun	1
MuraliMani	ElkeA.Rundensteiner	2
RicardodaSilvaTorres	EdwardA.Fox	1
TaneliMielik*inen	GautamDas	1
PeterR.Pietzuch	MattWelsh	1
RongShe	KeWang	2
PrateekJain	IriniFundulaki	1
RedaAlhajj	KenBarker	1
HiroyukiNasu	HiroyasuMinami	1
YonggeWang	YingjiuLi	1
LiWei	HelgaVanHerle	1
ThomasA.Russ	PhilipMaechling	1
ZunpingCheng	NingShang	1
XiaolinLi	SenmiaoYuan	1
WilliamH.Milnor	MatthewPerry	1
GuorenWang	GeYu	1
XiangZhang	Wing-KaiHon	1
AnandMeka	AmbujK.Singh	1
YuniXia	SunilPrabhakar	2
MichaelRys	IstvanCseri	1
VaishaliHegde	NaiyanaTansalarak	1
LourensVeen	Hans-J*rgSchek	1
ElizabethSugarBoese	AdeleE.Howe	1
SlobodanRasetic	J*rgSander	1
XinLunaDong	JingMichelleLiu	1
MichaelMoossen	Mar*a-CristinaRiff	1
WangZhang	BotaoWang	1
XinLi	CyrusShahabi	1
SundarSaiprasad	BertVanderLinden	1
J*rgenBeringer	EykeH*llermeier	1
RiccardoRosati	MichaelFink	1
SpirosPapadimitriou	AlexanderHinneburg	1
MartinMozina	AleksJakulin	1
RadaChirkova	FotoN.Afrati	1
ShigekiMatsubara	KatsunobuItou	1
Jos*deJes*sP*rezAlc*zar	EdmundoRobertoMauroMadeira	1
Jia-YuPan	ArnabBhattacharya	1
PurnamritaSarkar	AndrewW.Moore	1
PhilipK.Chan	Hyoung-raeKim	1
KrzysztofKoperski	GiovanniB.Marchisio	1
NesimeTatbul	Jeong-HyonHwang	1
TaneliMielik*inen	HeikkiMannila	1
UlrichThiel	ThomasKamps	1
JimKleewein	GuyM.Lohman	1
MatthewMichelson	MartinMichalowski	1
TakeharuEda	MasashiYamamuro	1
V*ctorRobles	*scarCubo	2
DavidB.Lomet	BrianRandell	1
WalidG.Aref	ChristopherW.Clifton	1
TuBaoHo	CanhHaoNguyen	1
ShengMa	FengLiang	1
FelixNaumann	ChristophB*hm	1
EltonRexhepaj	AlexandrosKalousis	1
YukiyoTakasago	AkiKobayashi	1
ShankarPal	DraganTomic	1
HuaHuo	BoqinFeng	1
FotoN.Afrati	AristidesGionis	1
GregoryC.Sharp	BettySalzberg	1
ToreRisch	JohanPetrini	1
SharadMehrotra	BalakrishnaR.Iyer	1
NaizhenQi	HamidPirahesh	1
WeiYu	IstvanCseri	1
ViswanathanKrishnamurthy	Anh-TuanTran	1
TakayukiShiga	MizuhoIwaihara	1
PedroDomingos	ParagSingla	1
MarcoRuzzi	EdytaKalka	1
Willem-JanvandenHeuvel	ToreRisch	1
MitsuhiroWada	MasatoKoyamaishi	1
NaizhenQi	JussiMyllymaki	1
Seung-HyunJeong	KeithT.Mason	1
JuanHern*ndez	ErnestoPimentel	1
BedoorK.AlShebli	AnHaiDoan	1
DavidA.Grossman	ClementT.Yu	1
ZhenjieZhang	XinyuGuo	1
RolandOrre	AndrewBate	1
PaoloCeravolo	CristianoFugazza	1
MichaelFink	GiorgioTerracina	1
ValentinaSvicher	GerdF*tkenheuer	1
NobuoKumagai	MasayoshiAritsugi	1
LatifurKhan	FatmaBouali	1
Kang-KwongLuke	GuohongFu	1
XuelongLi	StephenJ.Maybank	1
SamuelEdoho-Eket	BradleyMalin	1
ZhengxuanWang	ShaobinHuang	1
LanYe	BehrokhSamadi	1
WeiWang0010	MohammedJaveedZaki	1
GeorgeKarypis	Eui-HongHan	1
NobuoKawaguchi	KazuyaTakeda	1
ZhengChen	NingLiu	1
Ming-SyanChen	In-YeeLee	1
YifengZheng	YiChen	1
UtkarshSrivastava	NimrodMegiddo	1
SusanPaulsen	JanPrins	1
SungMinBae	Sang-ChanPark	1
NigelEllis	Jos*A.Blakeley	1
TamaraG.Kolda	JosephP.Kenny	1
JingrenZhou	DavidDeHaan	1
Jens-PeterDittrich	DonaldKossmann	3
SridharGullapalli	GurmeetSingh	1
YizhouWang	FangChu	1
ReynoldCheng	RahulShah	1
TolgaBozkaya	SankarSubramanian	2
YanqingZhang	IllhoiYoo	1
JafarAdibi	DunjaMladenic	1
WeiHong	AmolDeshpande	1
SatoshiNakamura	ChiyomiMiyajima	1
ShannonHastings	RenatoFerreira	1
YingLai	RatkoOrlandic	1
PedroBizarro	JenniferWidom	1
SongcanChen	FuyanZhang	1
VivekR.Narasayya	RahulKapoor	1
VladimirZadorozhny	LouiqaRaschid	1
Mohand-SaidHacid	ElisaBertino	1
OliverM.Donzelli	GiuseppeDeNicolao	1
Ken'ichiIshikawa	Jun'ichiTanaka	1
MyraSpiliopoulou	BamshadMobasher	1
XiaochunYang	LeiShi	1
MiguelA.Laguna	BrunoGonz*lez-Baixauli	1
SteveB.Jiang	HuanmeiWu	1
ZhiyongPeng	QingLi	1
ShingoKuroiwa	KazuyaTakeda	1
MinghuaZhang	DavidWai-LokCheung	1
ZhaoHuiTang	Pyungchul(Peter)Kim	1
JiuyongLi	HuidongJin	1
DavidMarx	AshokSamal	1
OrkutBuyukkokten	MehranSahami	1
RachelPottinger	LaksV.S.Lakshmanan	1
RuomingJin	ChaoWang	1
SayginCelebi	DheerendranathMundluru	1
VolkerMarkl	NimrodMegiddo	1
SanjayKumarMadria	ErwinLeonardi	1
YanchangZhao	ShichaoZhang	1
Jong-TaeLim	Dae-WonKim	1
RuiXiao	BehrokhSamadi	1
VincenzinoLio	NicolaLeone	1
QingzhaoTan	DikLunLee	1
ChristopherOlston	AmitManjhi	1
YunyueZhu	MohamedF.Mokbel	1
PatCase	JayavelShanmugasundaram	1
NaokiAmma	KenHiguchi	1
TaketoshiUshiama	MasakazuIkezaki	1
MelanieWeis	JensBleiholder	1
WynneHsu	JunmeiWang	2
RaviKumar	PhokionG.Kolaitis	1
MayaRamanath	JayantR.Haritsa	1
ShinYamamoto	SatoshiMori	1
RaviVijay	IoanaManolescu	1
StephaneChiocchetti	KaveEshghi	1
NathalieJapkowicz	JerffesonTeixeiradeSouza	1
NormanW.Paton	KeithT.Mason	1
JinLi	DavidMaier	2
LuZhang	FransCoenen	1
WitoldStaniszkis	BartoszNowicki	1
LizhuZhou	ChunxiaoXing	1
YingChen	BenyuZhang	1
PhilipBohannon	MichaelFlaster	2
R.BharatRao	MehmetDundar	1
Tak-ChungFu	Fu-LaiChung	1
ShlomoArgamon	CaseyWhitelaw	1
XiaCao	AnthonyK.H.Tung	1
YolandaGil	SridharGullapalli	1
YiLi	OsmarR.Za*ane	1
LimsoonWong	ChunyuJiang	1
HirokoMano	HideoItoh	1
LuborKoll*r	ArunprasadP.Marathe	1
MuSu	Chi-HungChi	1
EvandroBacarin	ClaudiaBauzerMedeiros	1
LathaS.Colby	KevinS.Beyer	1
ToreRisch	ThomasKabisch	1
VassilisPapadimos	PeterA.Tucker	2
YaBingChen	TokWangLing	1
PhilippR*sch	Kai-UweSattler	1
RaviRajwar	BrianRandell	1
WolfgangFaber	ThomasEiter	1
PhilipS.Yu	KevinDrummey	1
SridharGullapalli	CarlKesselman	1
NormanW.Paton	NassimaDjafri	1
WeimingHu	StephenJ.Maybank	1
PeerKr*ger	MatthiasRenz	1
RavindraGuravannavar	H.S.Ramanujam	1
RobertaCochrane	RobertLyle	1
GiladMishne	AyaSoffer	1
LorraineMcGinty	BarrySmyth	1
SridharGullapalli	MarcSpraragen	1
XingzhiSun	SonN.Nguyen	1
RaymondT.Ng	GaneshRamesh	1
YokoKamidoi	Shin'ichiWakabayashi	2
TomohiroEndo	MitsuhiroWada	1
MartinTheobald	GeorgeTsatsaronis	1
NikoBeerenwinkel	KlausKorn	1
StratisViglas	RobertMann	1
WeimingHu	DachengTao	1
WilfriedTeiken	StephenC.Gates	1
LeiChen0002	GordonB.Agnew	1
ShivnathBabu	PedroBizarro	3
YannisPetrakis	ThodorisTsotsos	1
JonM.Kleinberg	ChristosFaloutsos	2
ChristophF.Eick	AbrahamBagherjeiran	1
VenkateshGanti	KrisGanjam	1
ElisaBertino	ChristopherW.Clifton	1
HetalThakkar	CarloZaniolo	1
YuhongYan	MartinBrooks	1
VassilisAthitsos	GeorgeKollios	1
Jian-WeiLiu	DimitriosGunopulos	1
J.Padr*nLorenzo	E.VictorS*nchezRebull	1
J.Padr*nLorenzo	J.D.Garc*aLuna	1
KameshMunagala	JenniferWidom	1
ShigeruShimada	MasaakiTanizaki	1
MarkR.Verardo	Hyung-JeongYang	1
ToshihideSutou	KeiichiTamura	1
WilliamI.Grosky	MichaelD.Morse	1
StephenLangella	KunHuang	1
PereAlbert*	JorgeD*ez	1
RobertMcCann	QuocLe	1
LipingJing	JunXu	1
RobertStockton	MatthewSiegler	1
GautamDas	FotoN.Afrati	1
SergioStorari	EvelinaLamma	1
VictorTeixeiradeAlmeida	UlrichTelle	1
WynneHsu	ChenyiXia	1
VijayshankarRaman	DanielC.Zilio	1
DavidT.Liu	AlexanderS.Szalay	1
MichaelKassoff	Lee-MingZen	1
ZhiqiangZhang	QiGuo	1
NaotakeKitagawa	MasatoshiYoshikawa	1
JianpingFan	HangzaiLuo	2
LyleH.Ungar	JingZhou	1
YongXiaojia	ChuanLi	1
Xu-binDeng	JiankuiGuo	1
MichaelFink	MaurizioLenzerini	1
GurmeetSingh	CarlKesselman	1
DiveshSrivastava	BengChinOoi	1
JoydeepGhosh	ChaseKrumpelman	1
RalfSchenkel	MartinTheobald	1
EdmondLau	AmersonLin	1
TakashiTomokiyo	KamalNigam	1
Jos*A.Cars*	IsidroRamos	1
PatrickBaldasare	LianYan	1
WitoldStaniszkis	MarcoRuzzi	1
ThomasEiter	MichaelFink	1
TakashiTomii	KenichiKaku	1
SlobodanRasetic	MarioA.Nascimento	1
WeiHan	VishalS.Batra	2
NikosKyrpides	FrankKorzeniewski	1
YuqiangGuan	BrianKulis	1
NassimaDjafri	AlvaroA.A.Fernandes	1
YehoshuaSagiv	YaronKanza	1
MichaelRys	EugeneKogan	1
MuratDundar	GlennFung	1
SurajitChaudhuri	RavishankarRamamurthy	1
HongxingHe	ChrisKelman	1
YoshinoriSakai	KatsunoriYamaoka	2
SudiptoGuha	KyuseokShim	1
MuralidharKrishnaprasad	DanielaFlorescu	1
PhilippePucheral	NicolasDieu	1
YoshinoriHara	VishalSikka	1
KfirZigdon	JonathanSchler	1
XiaojunWan	BinggongDing	1
RaffaellaRinaldi	AlfioMassimilianoGliozzo	1
YunyueZhu	RuiWang0002	1
TimosK.Sellis	AlkisSimitsis	1
MarcosM.Campos	JosephYarmus	1
YokoMizuta	NigelCollier	1
AnjaliJhingran	AlexRasin	1
YonggeWang	XintaoWu	2
RajaBose	IbrahimKamel	1
ElizabethJ.O'Neil	AdamBatkin	1
JeffreyF.Naughton	AmeetKini	1
Ying-HanLiu	San-YihHwang	1
Chung-WenCho	ArbeeL.P.Chen	1
AndrewWitkowski	AbhinavGupta	1
GianpieroLiuzzi	ChristianHerzog	1
ShojiroNishio	HirokazuTomiyasu	1
ShrikanthShankar	NathanFolkert	1
YuelongJiang	KeWang	1
RogerZimmermann	AliE.Dashti	1
MoChen	Hua-JunZeng	1
SergeAbiteboul	RichardHull	1
MengChangChen	ChienChinChen	1
JohannesGehrke	AdinaCrainiceanu	1
MaryRoth	LauraM.Haas	1
ThomasA.Russ	BrianMendenhall	1
Rog*riodeLemos	Marie-ClaudeGaudel	1
WeiHong	ChristopheDiot	1
PatriciaM.West	BruceLambert	1
PanayiotisTsaparas	HeikkiMannila	3
MichaelRys	DraganTomic	1
RutSiguroardottir	LaurentAmsaleg	1
CliffB.Jones	AlanFekete	1
Wei-YingMa	QianShengCheng	1
ToreRisch	PhilippeThiran	1
ZhiyongPeng	YiLuo	1
TakashiWashio	PhuChienNguyen	1
StephenBay	DragosD.Margineantu	1
SurajitChaudhuri	NicolasBruno	2
Ren*eJ.Miller	JohnMylopoulos	2
Ren*eJ.Miller	ArielFuxman	2
ShingoKuroiwa	MitsunoriMizumachi	1
FotoN.Afrati	ChenLi	1
GaneshRamakrishnan	DeepaParanjpe	1
VadirajaBhatt	FrancisPang	1
Woo-CheolKim	Jung-ImWon	1
DraganTomic	DenisChurin	1
XuanHieuPhan	SusumuHoriguchi	1
GyuSangChoi	ChitaR.Das	1
GajananS.Chinchwadkar	FrancisPang	1
YanivBernstein	JustinZobel	2
VictorVianu	LiyingSui	1
ZhengSun	PhilipS.Yu	1
YimingYang	Tie-YanLiu	1
StephenLangella	*mitV.*ataly*rek	1
TakeshiYamada	NorihideKitaoka	1
RahulKapoor	KrisGanjam	1
Mich*leSebag	KouzouOhara	1
Per-*keLarson	JingrenZhou	2
CesarBerrospi	AbderrahimLabbi	1
RicardodaSilvaTorres	LucianoA.Digiampietri	1
ValentinaSvicher	NikoBeerenwinkel	1
PhilipS.Yu	BenjaminC.M.Fung	2
ShuangLiu	ClementT.Yu	2
GuidoMiraglia	FedericoDiPalma	1
XiaotongShen	WingHungWong	1
Chun-ShengChen	AbrahamBagherjeiran	1
LingWang	LichengJiao	1
XiangZhang	ArifGhafoor	1
YoshinoriSakai	YasuhiroInazumi	1
PeterFankhauser	LiboChen	1
VenkateshGanti	TheoVassilakis	1
LiseGetoor	ChristopherP.Diehl	2
Shou-JianYu	EamonnJ.Keogh	1
NickKoudas	JohannesGehrke	1
JoachimHammer	JanD.Gehrke	1
DmitryB.Goldgof	AndrewRemsen	1
LeefengChien	BenyuZhang	1
StevenC.H.Hoi	RongJin	1
ZhichengZhang	DavidJ.Hand	1
RobertB.Allen	Il-YeolSong	1
EricLo	DonaldKossmann	1
VassilisAthitsos	PhilipS.Yu	1
ZahirBalaporia	BrettBanich	1
RanWolff	AmirBar-Or	1
VipinGupta	JihieKim	1
YogeshSimmhan	BethPlale	1
ManabuOkumura	HiroyaTakamura	2
PrakashLinga	JayavelShanmugasundaram	1
MarcoBrambilla	AldoBongio	1
SukhoLee	BongkiMoon	1
WitoldStaniszkis	GiovambattistaIanni	1
WeiWang0011	JianzhongLi	1
VadirajaBhatt	GajananS.Chinchwadkar	1
TorstenGrabs	FuatAkal	1
ThomasA.Russ	SridharGullapalli	1
NitinKumar	MichalisVazirgiannis	1
RonaldFagin	D.Sivakumar	1
VictorM.Markowitz	ErnestSzeto	1
Hyung-JeongYang	AmbujK.Singh	1
WeiguoFan	EdwardA.Fox	2
WeiYu	OliverSeeliger	1
XinyuGuo	HuaLu	1
XiaojunWan	MuLi	1
SrinivasanParthasarathy	GaganAgrawal	1
TonyPan	JoelH.Saltz	1
YidongYuan	QingLiu	1
ThienNguyen	GiovanniB.Marchisio	1
VadirajaBhatt	AnupamSingh	1
GeorgeH.L.Fletcher	CatharineM.Wyss	1
VeliBicer	GokceLaleci	1
TakuyaHiraoka	ShirohHoribe	1
SoumenChakrabarti	ChristopherOlston	1
NileshN.Dalvi	ChristopherR*	1
RahulRamachandran	JosephTerry	1
GregoryBuehrer	AmolGhoting	1
TorstenGrabs	ChristianKleinerman	1
JosephTerry	BilahariAkkiraju	1
WarrenShen	VanithaVaradarajan	1
GuyM.Lohman	BrianVickery	1
VladoKeselj	EvangelosE.Milios	1
ShingoKuroiwa	KazumasaYamamoto	1
MaddalenaGarzetti	AnastasiosKementsietsidis	1
MaureenDougherty	BrianMendenhall	1
PengLiu	BaihuaZheng	1
SamuelMadden	MagdalenaBalazinska	1
RajaTanveerIqbal	CostinBarbu	1
RossSparks	AdaWai-CheeFu	1
RichardT.Snodgrass	M.Tamer*zsu	2
TranA.Dung	CaoD.Nguyen	1
QiangWang	ChristosFaloutsos	1
OluSobulo	AnHaiDoan	1
Xu-binDeng	BeijunRuan	1
MarcSpraragen	HansChalupsky	1
PhilippeMichiels	JanHidders	1
TuongC.Truong	BrianVickery	1
JieLian	GordonB.Agnew	1
ZahirTari	PeterBert*k	1
SebastianMichel	GerhardWeikum	2
GaganAgrawal	DmitriiPolshakov	1
YuMeng	LinLu	1
RicardodaSilvaTorres	Andr*Santanch*	1
WilliamM.Pottenger	TianhaoWu	1
XiaoxinYin	DongXin	1
PhilipMaechling	CarlKesselman	1
M.Tamer*zsu	KshirasagarNaik	1
PanagiotisPapapetrou	DimitriosGunopulos	1
ChengXiangZhai	BinTan	1
Yen-KuangChen	PradeepDubey	1
K.K.Loo	IvyTong	1
FabrizioRiguzzi	EvelinaLamma	1
JimKleewein	BertVanderLinden	1
TonyPan	MatheusRibeiro	1
VijayshankarRaman	InderpalNarang	3
ZhiyuanChen	DiveshSrivastava	1
RobertoAcerbis	PieroFraternali	1
MauricevanKeulen	AnderdeKeijzer	1
VenkataNishanthLolla	Chotirat(Ann)Ratanamahatana	1
MarianoCilia	AlejandroP.Buchmann	1
DiveshSrivastava	AmitMarathe	1
PeterBruza	GuihongCao	1
MortezaMonemizadeh	MohammadGhodsi	1
ChenWang	BaileShi	2
PradeepDubey	AmolGhoting	1
JijiZhang	JamesG.Shanahan	1
YimingYang	Wei-YingMa	1
JianpingFan	ElisaBertino	1
MarianaJbantova	BradleyMomberger	1
MichaelFink	DomenicoLembo	1
J.EliotB.Moss	AlanFekete	1
TonyPan	StephenLangella	1
YukiMitsunaga	HiroshiMotoda	1
NgocThanhNguyen	MichalMalowiecki	1
SouravS.Bhowmick	ErwinLeonardi	2
Juan-CarlosJusem	DavidEmmitt	1
LydiaBoudjeloud	Fran*oisPoulet	1
LimsoonWong	DonnySoh	1
YasunoriYamamoto	ToshihisaTakagi	1
SooyoungYoo	JinwookChoi	1
QiangZhu	FengYan	1
WaiHanHo	PaulAndrewWatters	1
XiaofangZhou	GeYu	1
TedYounglove	SeanCox	1
RonanCummins	ColmO'Riordan	1
PhilippeCudr*-Mauroux	KarlAberer	1
ShirohHoribe	HirokoMano	1
JianPei	ChenWang	1
HirokiShirato	BettySalzberg	1
YannisSismanis	NickRoussopoulos	1
MartaRukoz	Genevi*veJomier	1
WenfeiFan	RobertMann	1
KrithiRamamritham	HenryF.Korth	1
MarkusPeters	IraAssent	1
XifengYan	DengCai	1
VishalSikka	AnastassiaAilamaki	1
Lo*ckLhote	Fran*oisRioult	1
RobertaCochrane	BrianVickery	1
RadaChirkova	KennethA.Ross	1
VukErcegovac	RaghuRamakrishnan	1
RaymondJ.Mooney	ArindamBanerjee	1
NikosMamoulis	DavidW.Cheung	1
ParaskevasEvripidou	GeorgeSamaras	1
SubramanianArumugam	ShantanuJoshi	1
KazumiKuriyama-Matsumura	AkihikoKonagaya	1
SangjunLee	DongseopKwon	1
WangChiewTan	LauraChiticariu	1
JiaweiHan	DavidA.Padua	1
JingZhou	DeanP.Foster	1
GeorgeKarypis	AlMamunurRashid	1
ZografoulaVagena	MirellaMouraMoro	1
DavidD.Lewis	AleksanderKolcz	1
WalidRjaibi	RakeshAgrawal	1
MauricevanKeulen	JanRittinger	1
MihaiSurdeanu	JordiTurmo	1
MilenkoPetrovic	Hans-ArnoJacobsen	1
Jia-YuPan	ChristosFaloutsos	1
IbrahimKamel	AhmedK.Elmagarmid	1
SunilMovva	RahulRamachandran	1
QiankunZhao	LeGruenwald	2
RobertoJ.BayardoJr.	RakeshAgrawal	1
TakeshiFukuda	RyoHirade	1
MarioDiwersy	GianpieroLiuzzi	1
Kyu-YoungWhang	ElisaBertino	1
ZhimingDing	ThomasBehr	1
NingZhang0002	KennethSalem	1
RobertAdams	JunghooCho	1
NicolasWerro	MartinAlbrecht	1
YuxinChen	BaopingZhang	1
NicoletaPreda	IoanaManolescu	1
YanqingZhang	XiaohuaHu	1
VictorVianu	EllisHorowitz	1
NoureddineMouaddib	GuillaumeRaschia	1
LucMoreau	JamesE.Dobson	1
VishalSikka	ArnonRosenthal	1
YongtaiZhu	JianPei	1
HongGuo	FengYan	1
RamanathanV.Guha	JasmineNovak	1
KeWang	JianPei	1
YuniXia	JianzhongSun	1
WarrenShen	AnHaiDoan	1
DamienMcAullay	AdaWai-CheeFu	1
TakuyaMaekawa	HirokazuTomiyasu	1
SergeyMelnik	ErhardRahm	1
SivasankaranChandrasekar	Anh-TuanTran	1
JohnRiedl	AlMamunurRashid	1
WeiWang	HaixunWang	1
TakuyaMaekawa	ShojiroNishio	1
YinghuaZhou	XingXie	1
PatrickPantel	JafarAdibi	1
ZahirBalaporia	JaideepVaidya	1
RolfLak*mper	Chotirat(Ann)Ratanamahatana	2
NihanKesimCicekli	AsumanDogac	1
YuxinChen	MarcosAndr*Gon*alves	1
MasatoKitajima	KentaroWakatsuki	1
RobertA.Stine	DeanP.Foster	1
Shou-JianYu	Jian-WeiLiu	2
WanliZuo	Tian-yangLv	1
ZacharyG.Ives	JenniferWidom	1
Lee-MingZen	AnkitGarg	1
SatoshiNaoi	HaruoYokota	1
Fang-zhongSu	BeijunRuan	1
TedYounglove	MinhLy	1
YahyaSlimani	EngelbertMephuNguifo	1
EvelineHoekx	BartGoethals	1
SaikatMukherjee	AmarjeetSingh	1
EamonnJ.Keogh	AdaWai-CheeFu	2
WitoldStaniszkis	ThomasEiter	1
KanghengWu	JeffreyJunfengPan	1
YuanyuanJia	PatriciaM.West	1
FlorianWaas	C*sarA.Galindo-Legaria	1
YixinChen	ShuqingHuang	1
MichaelA.Harrison	DanielJ.Rosenkrantz	1
LeopoldoE.Bertossi	AlexThomo	1
TobiasSing	KlausKorn	1
KarstenDraba	FelixNaumann	1
RobertaCochrane	HamidPirahesh	1
ZiyingLiu	AlakaMullick	1
YuheiAkahoshi	KatsumiTanaka	1
MartinEster	JiaweiHan	1
SvenHelmer	MatthiasBrantner	1
OsmarR.Za*ane	MohammadEl-Hajj	3
KaranVahi	EwaDeelman	1
BoYang	AliR.Hurson	1
GerritK.Janssens	ArthurLim*re	1
NileshN.Dalvi	DanSuciu	3
GilbertoZontaPastorelloJr.	Andr*Santanch*	1
JohnMylopoulos	AnastasiosKementsietsidis	1
ManoranjanDash	DeepakKolippakkam	1
ToddC.Mowry	AnastassiaAilamaki	2
RichardKirkby	GeoffreyHolmes	1
ChunZhang	BrianVickery	1
MichaelStonebraker	MagdalenaBalazinska	2
W.BruceCroft	AlistairMoffat	1
Rog*riodeLemos	KrithiRamamritham	1
ShuigengZhou	JihongGuan	1
SihemAmer-Yahia	JayavelShanmugasundaram	2
RadaChirkova	JingrenZhou	1
VassilisJ.Tsotras	MariosHadjieleftheriou	1
TimothyM.Sutherland	BinLiu	1
NaveenAshish	DavidG.Bell	1
SaharonRosset	BiancaZadrozny	1
ThomasA.Russ	CarlKesselman	1
MichaelStonebraker	Jeong-HyonHwang	1
Jian-WeiLiu	EamonnJ.Keogh	1
XiaochunYang	ChenLi	1
YanifAhmad	StanleyB.Zdonik	1
SuryaNepal	DeanKuo	1
HuidongJin	AdaWai-CheeFu	1
ManojSyamala	LuborKoll*r	1
XiaoliZhangFern	CarlaE.Brodley	1
XiaokuiXiao	BenKao	1
ParkeGodfrey	AlexThomo	1
HyunjinYoon	CyrusShahabi	1
LaksV.S.Lakshmanan	AngelaBonifati	1
JinHuang	CharlesX.Ling	3
JiuyongLi	DamienMcAullay	1
ShivnathBabu	JenniferWidom	2
V*clavSn*sel	Tom*sSkopal	1
Lu*sRodrigues	CliffB.Jones	1
YonggeWang	YingWu	1
TomohiroEndo	MasatoKoyamaishi	1
SamuelMadden	DanielJ.Abadi	2
KatunobuItou	FumitadaItakura	1
WeiHong	RameshGovindan	2
RistoA.V*is*nen	ChristosFaloutsos	1
YuxinChen	EdwardA.Fox	1
NigelEllis	Ming-ChuanWu	1
WolfgangNejdl	Wolf-TiloBalke	1
LucianoA.Digiampietri	EvandroBacarin	1
RuiXiao	MinhLy	1
TaoTao	ChengXiangZhai	2
TillMerker	ClaudiaT*ubner	1
WeiWang0009	TianyiWu	1
VladislavShkapenyuk	StavrosHarizopoulos	1
NarainH.Gehani	AntonisKoufopoulos	1
PedroGabrielFerreira	PauloJ.Azevedo	1
Ken'ichiIshikawa	AtsuyukiMorishima	1
DavidGondek	AshutoshGarg	1
YoonkyongLee	MayssamSayyadian	1
W.BruceCroft	MatthewB.Koll	1
WagnerMeiraJr.	BrunoP*ssas	1
EdmundoRobertoMauroMadeira	Andr*Santanch*	1
SanjayAgrawal	LuborKoll*r	1
V*ctorRobles	Jos*M.Pe*aS*nchez	1
VikasArora	NipunAgarwal	1
CuiZhu	ChristosFaloutsos	1
JiaweiHan	HongCheng	3
JonghoonChun	HeekyongPark	1
ShrikanthShankar	AndrewWitkowski	1
VanjaJosifovski	NingZhang0002	1
MouradOuzzani	AnnChristineCatlin	1
GuoLi	ChristosFaloutsos	1
WeiYu	ShankarPal	1
Mar*aA.Nieto-Santisteban	AlexanderS.Szalay	1
SabineMassmann	DavidAumueller	1
SrikanthBellamkonda	AllisonWaingold	1
WolfgangFaber	EdytaKalka	1
PeterM.Fischer	Jens-PeterDittrich	1
WenjuanXing	AnjaliJhingran	1
ThomasM.Tirpak	BingLiu	2
Ming-SyanChen	Ming-JyhHsieh	1
SusanKotsovolos	MuralidharKrishnaprasad	1
WalidRjaibi	PaulBird	1
FarookhKhadeerHussain	BenSoh	1
TovaMilo	SimonKamenkovich	1
FrancescaCeccherini-Silberstein	DanielHoffmann	1
MehediMasud	MaddalenaGarzetti	1
YuriBreitbart	CanT*rker	1
CuongAnhLe	AkiraShimazu	1
UlrichTelle	ThomasH*se	1
UlrichTelle	ThomasBehr	1
KiyohiroShikano	AtsunobuKaminuma	1
Zhongfei(Mark)Zhang	PhilipS.Yu	2
WarrenShen	RobertMcCann	1
MatthewPerry	AmitP.Sheth	1
TobiasSing	MartinD*umer	1
LauraM.Haas	HowardHo	1
RamanAdaikkalavan	QingchunJiang	1
ShinjiShimojo	MasatoKitajima	1
JingPeng	ChuanLi	1
WenjuanXing	AlexRasin	1
ElisaBertino	AhmedK.Elmagarmid	1
ZhihongChong	AoyingZhou	1
FengPan	AnthonyK.H.Tung	1
YingboMiao	EvangelosE.Milios	1
VictorTeixeiradeAlmeida	DirkAnsorge	1
MouradOuzzani	ChristopherW.Clifton	1
ToshiakiOkawara	AtsuyukiMorishima	2
XinChen	QuanzhiLi	2
ZhihuaCai	LiangxiaoJiang	1
DavidMaier	BillHowe	1
RaviVijay	AndreiArion	1
DraganTomic	AdrianBaras	1
MichaelStonebraker	ElizabethJ.O'Neil	1
TakanobuNishiura	KazuyaTakeda	1
ThodorisTsotsos	EvaggeliaPitoura	1
NikhilS.Ketkar	LawrenceB.Holder	1
VincenzinoLio	ThomasEiter	1
KellyPalmer	HenryG.Goldberg	1
J.EliotB.Moss	HenryF.Korth	1
Mar*aA.Nieto-Santisteban	GerdHeber	1
NickKoudas	Am*lieMarian	2
NipunAgarwal	DanielaFlorescu	1
ThomasKabisch	JohanPetrini	1
YongtaiZhu	XifengYan	1
JuliaStoyanovich	AngelJanevski	1
ZhengxuanWang	Tian-yangLv	1
RakeshAgrawal	PaulBird	1
TaniaCerquitelli	SilviaChiusano	1
VikasArora	SusanKotsovolos	1
YingYang	XingquanZhu	1
YahyaSlimani	SadokBenYahia	2
PhilShaw	AnupamSingh	1
HolgerMeyer	ElisaBertino	1
Jeong-HyonHwang	AnuragMaskey	1
JureLeskovec	JonM.Kleinberg	2
VipinGupta	GarrickStaples	1
XiangZhang	WalidG.Aref	1
VebjornLjosa	Hyung-JeongYang	1
MaureenDougherty	JihieKim	1
EdmundoRobertoMauroMadeira	ClaudiaBauzerMedeiros	1
CliffB.Jones	AlexanderB.Romanovsky	1
XinLi	BingLiu	1
YutakaKidawara	KatsumiTanaka	1
Shin'ichiKobayashi	NoriyoshiYamauchi	1
XifengYan	XiaofeiHe	1
VladimirZadorozhny	AvigdorGal	1
ToshihiroKoma	KenKurokawa	1
JiaweiHan	ChenWang	1
RachelPottinger	JingrenZhou	1
TaeHoKang	JaeSooYoo	1
WonikChoi	DongseopKwon	1
YingYan	Kian-LeeTan	1
EugeneKogan	DraganTomic	1
KazuhitoKobayashi	AkitsuguWatanabe	1
PhilipMaechling	GarrickStaples	1
TakehiroFurudate	SusumuDate	1
YunChi	RichardR.Muntz	1
PhilipA.Bernstein	ChristianS.Jensen	2
ThomasA.Russ	GaurangMehta	1
YanifAhmad	AnjaliJhingran	1
ZhuoweiLi	AmitabhaDas	1
QiangYang	KanghengWu	1
MatthiasSchubert	AlexeyPryakhin	2
BrunoP*ssas	BrunoM.Fonseca	1
Zhi-HuaZhou	FuyanZhang	1
SusumuDate	KentaroWakatsuki	1
ZhengChen	HaoWan	1
SamuelMadden	HariBalakrishnan	1
Pin-KwangEng	CheeYongChan	2
FarukPolat	AhmetCosar	1
LathaS.Colby	DonaldD.Chamberlin	1
MohamedMedhatGaber	ArkadyB.Zaslavsky	1
SheilaA.Greibach	SergeAbiteboul	1
HuaLu	AnthonyK.H.Tung	1
YihengLi	BradleyMalin	1
UnilYun	JohnJ.Leggett	2
OsmarR.Za*ane	Maria-LuizaAntonie	1
M.ErdemKurul	LiChen	2
YildirayKabak	VeliBicer	1
SumanNath	AmitManjhi	1
HideoMatsuda	GenKawamura	1
Kian-LeeTan	BinCui	1
PhilippeRigaux	C*dricduMouza	1
TimFurche	DanOlteanu	1
TakashiTomokiyo	NatalieS.Glance	1
VanjaJosifovski	MarcusFontoura	1
PauloBrazGolgher	BerthierA.Ribeiro-Neto	1
IstvanCseri	AdrianBaras	1
RuiWang0002	BettySalzberg	1
ZhihongChong	ZhengjieZhang	1
MichaelKassoff	AnkitGarg	1
PabloAmaya	JuanM.Murillo	1
Lu*sRodrigues	HenryF.Korth	1
RiadhBenMessaoud	OmarBoussaid	1
SunilPrabhakar	AhmedK.Elmagarmid	1
SunilPrabhakar	SarvjeetSingh	1
Jean-MarcAndreoli	GuillaumeBouchard	1
JiuyongLi	HongxingHe	1
YingYan	BengChinOoi	1
Ching-YungLin	BelleL.Tseng	1
Wook-ShinHan	Min-SooKim0002	1
Seung-HyunJeong	NassimaDjafri	1
ZhengChen	QiangYang	1
TonyF.Chan	AndyM.Yip	1
MichaelWilde	JamesE.Dobson	1
NickKoudas	AnthonyK.H.Tung	1
NitinKumar	MariaHalkidi	1
XiaohuiLiu	AllanTucker	1
GangLuo	CurtJ.Ellmann	1
MaurizioMazza	AnnaMaddalena	1
Woon-HakKang	Sang-WonLee	1
JieYin	DouShen	1
ToshihiroUehara	ManaNakano	1
ZhengxuanWang	Yu-huiXing	1
PongtawatChippimolchai	ChutipornAnutariya	1
Zolt*nSzamonek	CsabaSzepesv*ri	1
YanifAhmad	AlexanderZgolinski	1
OsmarR.Za*ane	BrijM.Masand	1
TianhaoWu	ShenzhiLi	1
MichailVlachos	JessicaLin	1
TakahiraYamaguchi	MihoOhsaki	1
SteliosPaparizos	H.V.Jagadish	1
WenxinLiang	DaiKobayashi	1
JeffreyScottVitter	ElisaBertino	1
PeterBruza	DaweiSong	1
RobertJ.Kingan	AlanHochberg	1
DavidJ.DeWitt	AmeetKini	1
ShuqingHuang	HenryL.BartJr.	1
VishalS.Batra	InderpalNarang	2
PhilipA.Bernstein	DavidJ.DeWitt	1
RameshGovindan	ChristopheDiot	1
StefanoCeri	PieroFraternali	1
AronCulotta	AndrewMcCallum	1
LiangJin	AnthonyK.H.Tung	1
RudolfKruse	FrankRehm	1
Jos*Iborra	Jos*A.Cars*	1
RuiXiao	LanYe	1
ShawnR.Jeffery	ShariqRizvi	1
MosheY.Vardi	MichaelA.Harrison	1
FlorianHaftmann	EricLo	1
SunilPrabhakar	JeffreyScottVitter	1
VincenzinoLio	MaurizioLenzerini	1
RyoNishide	MasayukiKawabata	1
JingMichelleLiu	AlonY.Halevy	1
JayavelShanmugasundaram	FengShao	1
SoumenChakrabarti	JunghooCho	1
WenfeiFan	ByronChoi	1
TapioSalakoski	TapioPahikkala	1
MagdalenaBalazinska	HariBalakrishnan	1
SridharGullapalli	BrianMendenhall	1
FarookhKhadeerHussain	ElizabethChang	1
ParkeGodfrey	JanChomicki	1
LeiChen0002	KshirasagarNaik	1
JunYan	BenyuZhang	2
MaureenDougherty	GarrickStaples	1
Fatma*zcan	BrianVickery	1
ReynoldCheng	BenKao	2
Marie-ClaudeGaudel	DavidB.Lomet	1
Jean-MarcPetit	Fr*d*ricFlouvat	1
ShonaliKrishnaswamy	MohamedMedhatGaber	1
Jia-YuPan	AmbujK.Singh	1
LimsoonWong	JinyanLi	2
ShunsukeUemura	JunMiyazaki	1
YutakaKatsuyama	TakashiKobayashi	1
YingXing	BradleyBerg	1
TadashiTsumura	RyoHirade	1
MemaRoussopoulos	MargoI.Seltzer	1
EsperanzaMarcos	DianaM.S*nchezFuquene	1
MinhLy	LanYe	1
ManaNakano	DaiKobayashi	1
NematollaahShiri	BhushanShankarSuryavanshi	1
YanivBernstein	DonaldMetzler	1
WeiWang0011	HongjunLu	3
MaryE.Edgerton	LewisFrey	1
MelanieHilario	AlexandrosKalousis	3
MaurizioAtzori	FoscaGiannotti	2
MarianoP.Consens	LaurentMignet	1
XiangjiHuang	AijunAn	1
MichaelH.B*hlen	JohannGamper	1
VladislavShkapenyuk	AmitManjhi	1
EdmondLau	AdamBatkin	1
EugeneJ.Shekita	BeverlyYang	1
WolfgangFaber	GiorgioTerracina	1
YoonkyongLee	ArnonRosenthal	1
Mohand-SaidHacid	Jean-MarcPetit	1
FrancescoBonchi	ClaudioLucchese	1
DennisN*rgaard	AlbrechtSchmidt0002	1
MatthewMichelson	CraigA.Knoblock	1
JohannesGehrke	FlipKorn	1
JenniferNeville	HenryG.Goldberg	1
MariosHadjieleftheriou	ManLungYiu	1
JoshuaHui	Hui-IHsiao	1
YuxinChen	P*velCalado	1
RaviKumar	DanielGruhl	1
RongPan	QiangYang	1
LongVu	BedoorK.AlShebli	1
RajaBose	AbdelsalamHelal	1
ThomasFahringer	MarekWieczorek	1
ZhenHuaLiu	AnandManikutty	1
DanielLemire	AnnaMaclachlan	1
PraveenRao	JoonhoKwon	1
OphirFrieder	DavidD.Lewis	1
JuanHern*ndez	Jos*AmbrosioToval*lvarez	1
SongboTan	MoustafaGhanem	1
Ugur*etintemel	BradleyBerg	1
YoonkyongLee	AnHaiDoan	1
SujataBanerjee	PanosK.Chrysanthis	1
SudarshanLamkhede	AnmolBhasin	1
PhilipMaechling	GurmeetSingh	1
WingSingWong	JianliangXu	1
XiaokuiXiao	ReynoldCheng	1
TianyiWu	JianXu	1
WeiweiSun	QingZhang	1
RaviMurthy	DanielaFlorescu	1
ZhiyuanChen	NickKoudas	1
NavenduGarg	CaseyWhitelaw	1
RichardNock	Jean-EmileSymphor	1
QinLu	KenC.K.Lee	1
NicolasDieu	LucBouganim	1
GeoffreyHolmes	BernhardPfahringer	1
MarcSpraragen	JihieKim	1
KlausKorn	HaukeWalter	1
MariaIsabelSobralEscada	GilbertoC*mara	1
BiancaSchroeder	AnastassiaAilamaki	1
JunGuo	GangLiu	1
GerhardWeikum	ChristianZimmer	1
MiguelFerreira	AmersonLin	1
YongluanZhou	BengChinOoi	2
UmbertoStraccia	HenrikNottelmann	1
NihanKesimCicekli	AdnanYazici	1
ThomasLengauer	NikoBeerenwinkel	1
DanielKeren	AssafSchuster	1
ShannonHastings	KunHuang	1
JenniferWidom	DavidJ.DeWitt	2
LucianPopa	CongYu	1
MikeFoedisch	MichaelShneier	1
CarsonMurray	AnnePusey	1
DomenicoLembo	BartoszNowicki	1
KevinDrummey	JoeMcCloskey	1
Shinn-YingHo	Chih-HungHsieh	1
KeshengWu	DoronRotem	1
Kuo-ZuiLin	Kuo-YuHuang	1
SrikanthSampath	Ghazi-NourdineBenadjaoud	1
SatoshiOyama	HiroakiOhshima	1
XifengYan	WeiWang0009	1
BradleyMomberger	BinLiu	1
PremMelville	FosterJ.Provost	1
BrandonBerg	AdrianBaras	1
MohamedA.Soliman	KevinChen-ChuanChang	1
XuanhuiWang	QiaozhuMei	1
PhilipS.Yu	HwanjoYu	1
FangLiu	ClementT.Yu	1
LeonardMcMillan	JingdanZhang	1
NingLi	KevinS.Beyer	1
XingJiang	Ah-HweeTan	1
QingzhaoTan	BaihuaZheng	1
J.GregorySteffan	AnastassiaAilamaki	1
TakuKudo	MasashiShimbo	1
RaviSundaram	D.Sivakumar	1
PhilipS.Yu	BiancaZadrozny	1
SpirosPapadimitriou	ChristosFaloutsos	5
RobertLyle	BertVanderLinden	1
TsutomuFujiwara	JunMiyazaki	1
XiaoguangLi	GeYu	1
RuiZhang0003	BengChinOoi	1
TheoVassilakis	KrisGanjam	1
PasiFr*nti	IsmoK*rkk*inen	1
GeorgGottlob	DomenicoLembo	1
ThorstenMeinl	MichaelPhilippsen	1
VipinGupta	CarlKesselman	1
HuanmeiWu	HirokiShirato	1
JianChu	HongyeSu	1
PeiSun	BavaniArunasalam	1
XiaofangZhou	XiangminZhou	1
TobiasSing	MarkOette	1
LouisLicamele	LisaSingh	1
SaraJ.Graves	Juan-CarlosJusem	1
KoenVanhoof	ArthurLim*re	1
ReinerKraft	Chi-ChaoChang	1
DavidMaier	AlonY.Halevy	1
San-YihHwang	Ee-PengLim	1
YiZhang0006	SamuelBurer	1
SanghyunPark	Sang-WookKim	2
Yu-huiXing	WanliZuo	1
RaviRajwar	KrithiRamamritham	1
AttilaBarta	AlbertoO.Mendelzon	1
SusumuDate	ShinjiShimojo	1
PeterA.Boncz	MauricevanKeulen	1
ZhenHuaLiu	NipunAgarwal	1
WeiWang0010	SrinivasanParthasarathy	1
YehoshuaSagiv	SaraCohen	1
Hsuan-TienLin	AmritPratap	1
MarkHumphrey	BradleyBerg	1
LongVu	AnHaiDoan	1
SteffenBickel	PeterHaider	1
UpendraSharma	AkshatVerma	1
NgaTran	MiguelFerreira	1
WenyuanLi	Kok-LeongOng	1
VikasArora	JamesW.Warner	1
StefanoVolinia	GiacomoGamberoni	1
GrahamJ.Williams	DamienMcAullay	1
GajananS.Chinchwadkar	AnupamSingh	1
MariaSalam*	LorraineMcGinty	1
OliverM.Donzelli	FedericoDiPalma	1
MihoMokuda	KazumitsuYagi	1
HongHaiDo	ErhardRahm	1
SusanneE.Hambrusch	MouradOuzzani	1
NaveenReddy	JayantR.Haritsa	1
SheilaA.Greibach	RichardHull	1
MayssamSayyadian	AnHaiDoan	1
TorstenGrabs	FlorianWaas	1
UtkarshSrivastava	TamMinhTran	1
YanifAhmad	AlexRasin	1
JohnKomoroske	JenniferNeville	1
YinghuaZhou	Wei-YingMa	1
VanjaJosifovski	KevinS.Beyer	1
YanqingZhang	Il-YeolSong	1
ToshihiroKamishima	ShotaroAkaho	1
YoshiyukiMizuno	ShinYamamoto	1
RossSparks	HongxingHe	1
Pyungchul(Peter)Kim	JamieMaclennan	1
XingXie	ChuangWang	1
StanleyB.Zdonik	SamuelMadden	1
NivioZiviani	BerthierA.Ribeiro-Neto	2
VanjaJosifovski	Fatma*zcan	1
JohnMylopoulos	IlujuKiringa	1
TaoWu	LingZhang	1
RongPan	JeffreyJunfengPan	1
KrithiRamamritham	J.EliotB.Moss	1
HuidongJin	ChrisKelman	1
J*rgenK.Rockstroh	GerdF*tkenheuer	1
GaurangMehta	BrianMendenhall	1
ThomasHofmann	DavidGondek	1
NicolasWerro	MiltiadisSarakinos	1
PhilippePucheral	CosminCremarenco	1
CatrielBeeri	AnatEyal	1
TsuyokiNishikawa	AkinobuLee	1
ToshihiroKoma	ShigehikoKanaya	1
YuXu	KevinS.Beyer	1
PeterM.Fischer	DonaldKossmann	2
V*roniqueBenzaken	IoanaManolescu	1
YunyueZhu	DavidB.Lomet	1
ClaudioMoraga	CarlosValle	1
ShinjiShimojo	GenKawamura	1
TimosK.Sellis	PanosVassiliadis	1
MarikoHatakeyama	KazumiKuriyama-Matsumura	1
NobuoKawaguchi	HiroshiFujimura	1
JunYang0001	HaiYu	1
XiaoxinYin	XiaoleiLi	1
Rog*riodeLemos	AlexanderB.Romanovsky	1
PeterA.Tucker	JinLi	2
WeiguoFan	RicardodaSilvaTorres	1
JingBai	Jian-YunNie	1
JingBai	DaweiSong	1
Wook-ShinHan	Kyu-YoungWhang	2
WalidG.Aref	IhabF.Ilyas	1
WeifengLi	KazuyaTakeda	1
SankarSubramanian	NathanFolkert	1
VincentOria	LeiChen0002	1
RaviRajwar	Lu*sRodrigues	1
SunilMovva	RobertAtlas	1
JiazhengShi	DavidMarx	1
PhilippeRigaux	MichelScholl	1
NanLiu	ChristopherC.Yang	1
LizhuZhou	ChaoLi	1
JinzeLiu	JanPrins	1
NorihideKitaoka	ChiyomiMiyajima	1
ZhiyongPeng	WeipingXie	1
MelanieWeis	ChristophB*hm	1
TuongC.Truong	Fatma*zcan	1
VebjornLjosa	MarkR.Verardo	1
MohamedH.Ali	AhmedK.Elmagarmid	1
KazukoTakahashi	HiroyaTakamura	1
YapingLin	RajuShrestha	1
XuedongChen	MitchCherniack	1
PhilipS.Yu	EdGreengrass	1
ThomasA.Russ	GarrickStaples	1
CarmenCostilla	ArantzaIllarramendi	1
TakahiroKosaka	GenKawamura	1
T.S.Jayram	RaghuRamakrishnan	1
LipingJing	JoshuaZhexueHuang	1
YingWu	XintaoWu	1
HamidPirahesh	BrianVickery	1
KevinS.Beyer	DonaldD.Chamberlin	1
HirokiShirato	DavidR.Kaeli	1
XiangLi	SunilMovva	1
SongWang	ElkeA.Rundensteiner	1
JieChen	ChrisKelman	1
ElisaBertino	ChristianS.Jensen	1
ZhihuaChen	DouglasH.Fisher	1
LuisGravano	JunghooCho	1
YingChen	JunYan	1
PatriciaRodr*guez-Gianolli	MaddalenaGarzetti	1
TakashiWashio	AlexandreTermier	1
IsmailHakkiToroslu	AsumanDogac	1
YangyongZhu	BeijunRuan	1
RyanRich	LanYe	1
YanifAhmad	JohnJannotti	1
SeemaSundara	JagannathanSrinivasan	1
ZacharyG.Ives	M.Tamer*zsu	1
JuanM.Murillo	CarlosGonz*lez	1
YangDu	TianXia	1
Mich*leSebag	AlexandreTermier	1
WalidG.Aref	MouradOuzzani	1
ShrikanthShankar	AbhinavGupta	1
JeffreyJunfengPan	DouShen	1
IanC.MacMillan	AlanS.Abrahams	1
JinwookChoi	HeekyongPark	1
ToshikiEndo	TakeshiYamada	1
SrikanthSampath	GajananS.Chinchwadkar	1
MohamedH.Ali	MohamedF.Mokbel	1
JiajinLe	CongtingXi	1
DavidCarmel	AlexeyRoytman	1
SrinivasanParthasarathy	RuomingJin	1
TamaraG.Kolda	BrettW.Bader	1
RiccardoRosati	BartoszNowicki	1
MaurizioLenzerini	MarcoRuzzi	1
WenQiangWang	BarbaraCatania	1
HiroyukiKitagawa	CuiZhu	1
RobertLyle	GuyM.Lohman	1
PatriciaRodr*guez-Gianolli	IlujuKiringa	1
Wen-SyanLi	VijayshankarRaman	2
MichaelR.Genesereth	MichaelKassoff	1
TakanobuNishiura	SatoshiNakamura	1
WataruNakano	TakashiKobayashi	1
XiangminZhou	GeYu	1
SergeAbiteboul	DanielJ.Rosenkrantz	1
VagelisHristidis	RamakrishnaVaradarajan	1
YaboXu	KeWang	2
Ming-ChuanWu	ConorCunningham	1
PhilipS.Yu	JianyongWang	1
TuongC.Truong	JimKleewein	1
JoelH.Saltz	*mitV.*ataly*rek	1
StellaLuk	OsmarR.Za*ane	1
SusanKotsovolos	DanielaFlorescu	1
TianYu	ChangqingLi	1
XifengYan	JiaweiHan	9
SteveBridges	PeterSiemen	1
PhilipA.Bernstein	JayantMadhavan	1
MarcSpraragen	EwaDeelman	1
EdytaKalka	BartoszNowicki	1
ToshikiEndo	MitsunoriMizumachi	1
NicolaLeone	BartoszNowicki	1
TongLuo	AndrewRemsen	1
MichaelRys	BrandonBerg	1
TatsuoTsuji	K.M.AzharulHasan	1
FangChu	CarloZaniolo	1
FrankKorzeniewski	ErnestSzeto	1
RuneS*tre	AmundTveit	1
WalidG.Aref	RajaBose	1
SeanCox	RyanRich	1
Jong-TaeLim	DoheonLee	1
YingXing	WenjuanXing	1
HangLi	DmitriyMeyerzon	1
SaharonRosset	ClaudiaPerlich	1
TobiasSing	RolfKaiser	1
TakashiWashio	Marie-ChristineRousset	1
WilliamM.Pottenger	ShenzhiLi	1
YasushiSakurai	SpirosPapadimitriou	2
ShiweiTang	PeixiangZhao	1
RoelVercammen	JanHidders	1
ShivakumarVaithyanathan	AshutoshGarg	1
FengShao	AntalNovak	1
MasatoKitajima	KazutoYamazaki	1
RobertaCochrane	ChunZhang	1
YutaOchi	SatoshiNaoi	1
YidongYuan	QingZhang	1
DeniseDraper	ArnonRosenthal	1
JesusTorresValderrama	AntoniaM.ReinaQuintero	1
CalistoZuzarte	AlexThomo	1
PhilippePucheral	B*atriceFinance	1
XiaojianZhao	DennisShasha	1
TerranLane	DragosD.Margineantu	1
StephenLangella	ShannonHastings	1
LimsoonWong	GuozhuDong	1
MaurizioLenzerini	GeorgGottlob	1
NoriakiKawamae	KatsumiTakahashi	1
TeresaBernardaLudermir	CleberZanchettin	1
PhilipA.Bernstein	AndreasHeuer	2
JingZhou	HongVaLeong	1
TheodoreDalamagas	NarainH.Gehani	1
RichardKirkby	BernhardPfahringer	1
VenkateshGanti	RajeevMotwani	1
PhilipS.Yu	HaoHe	1
ShobhitMathur	JihadBoulos	1
XiangLi	StevenGreco	1
ChristianSpieth	AndreasZell	1
HongHaiDo	DavidAumueller	1
NicolaH*nle	Mih*lyJakob	1
Jin-ohChoi	Jin-DeogKim	1
MartinS.Olivier	HendrikJ.G.Oberholzer	1
V.S.Subrahmanian	EdwardHung	1
JenniferWidom	AndreasHeuer	1
ShariqRizvi	MichaelJ.Franklin	1
Jeong-HyonHwang	AlexRasin	2
RobertLyle	BrianVickery	1
SimonKamenkovich	CatrielBeeri	1
RunaBhaumik	BamshadMobasher	2
WenliangDu	HuseyinPolat	1
WitoldStaniszkis	RiccardoRosati	1
Pierre-AlainLaur	Jean-EmileSymphor	1
Yi-ChengTu	BenKao	1
VarunPandey	NarenRamakrishnan	1
Thanh-DuyNguyen	RasmusKaae	1
NikolausAugsten	JohannGamper	1
RonenFeldman	MosheFresko	2
XuedongChen	AlexRasin	1
VijayshankarRaman	IvanPopivanov	1
YuMeng	MargaretH.Dunham	1
JohanPetrini	JeanHenrard	1
RenatoFerreira	*mitV.*ataly*rek	1
PhilipS.Yu	IanDavidson	1
WeiWang0009	ChenWang	2
NikosKyrpides	NataliaIvanova	1
MarianoP.Consens	AttilaBarta	1
ShravanChamakura	AlpaSachde	1
YasuhiroInazumi	KatsunoriYamaoka	1
XinLi	RameshGovindan	2
DimitriosGunopulos	DemetriosZeinalipour-Yazti	1
ShivnathBabu	DavidJ.DeWitt	3
VineetSinha	DavidR.Karger	1
YanjunLi	SoonMyoungChung	1
PeterJ.Haas	IvanPopivanov	1
AyaSoffer	AlexeyRoytman	1
ToshihiroUehara	AkitsuguWatanabe	2
PatrickE.O'Neil	ElizabethJ.O'Neil	1
NelsonF.F.Ebecken	AlexAlvesFreitas	1
PhilipMaechling	JihieKim	1
QingsongYao	AijunAn	1
StevenMinton	MartinMichalowski	1
ShariqRizvi	SaileshKrishnamurthy	1
NicolasDieu	Fran*oisDangNgoc	1
YolandaGil	MarcSpraragen	1
MartinLorenz	JoachimHammer	1
MasaruUeda	KazunoriSunako	1
MariaPratt	DieterGawlick	1
Zhi-HuaZhou	MingLi	1
MarcosAntonioVazSalles	LukasBlunschi	1
StanleyB.Zdonik	AdamBatkin	1
GerhardWeikum	DimitriosMavroeidis	1
QingLi	DimitrisPapadias	1
Young-HoPark	ByungSukLee	1
YeowWeiChoong	MarcPlantevit	1
StevenGreco	RahulRamachandran	1
PhokionG.Kolaitis	JanChomicki	1
ValentinaSvicher	ThomasLengauer	1
EamonnJ.Keogh	Chotirat(Ann)Ratanamahatana	6
VijayalakshmiAtluri	VandanaPursnaniJaneja	1
JinyanLi	DonnySoh	1
YousefSaad	EffrosiniKokiopoulou	2
Min-JaeLee	Jae-GilLee	2
GermanShegalov	DavidB.Lomet	1
NavneetPanda	EdwardY.Chang	2
YunyueZhu	RogerS.Barga	1
PhilippeThiran	JohanPetrini	1
Pei-WyYo	Jia-LingKoh	1
HenryF.Korth	AlanFekete	1
Yi-HongChu	Ming-SyanChen	1
SrikanthBellamkonda	AbhinavGupta	1
ZhengChen	Hua-JunZeng	1
GianlucaIannaccone	ChristopheDiot	1
NgaTran	AmersonLin	1
HenryF.Korth	DavidB.Lomet	1
NgaTran	ElizabethJ.O'Neil	1
ShengliSheng	NazimH.Madhavji	1
ShivnathBabu	KameshMunagala	1
ThomasLengauer	MartinD*umer	1
NickKoudas	LiangJin	1
CesarCardona	CarlosRojas	1
KurtStockinger	DoronRotem	1
Fran*oisRioult	ArnaudSoulet	1
SaeHwang	Jung-HwanOh	1
V*roniqueBenzaken	AndreiArion	1
FlorianWaas	ChristianKleinerman	1
WeiJiang	ChrisClifton	1
TahsinM.Kur*	KunHuang	1
GerhardWeikum	GeorgeTsatsaronis	1
KathleenGriffiths	DavidHawking	1
ToddC.Mowry	ChristopherB.Colohan	1
RaymondT.Ng	GiuseppeCarenini	1
DimitrisSacharidis	CyrusShahabi	1
PhilShaw	BharatRane	1
RossSparks	JieChen	1
PatriciaRodr*guez-Gianolli	MehediMasud	1
MariaHalkidi	DimitriosGunopulos	1
VipinGupta	MaureenDougherty	1
PengyueJ.Lin	DanielR.Jeske	1
TokWangLing	ChangqingLi	4
TsuyokiNishikawa	AtsunobuKaminuma	1
Willem-JanvandenHeuvel	ThomasKabisch	1
YaqinWang	JiankuiGuo	1
RichardHull	JeffreyD.Ullman	1
LourensVeen	FuatAkal	1
YuhanCai	XinLunaDong	1
YuchangGong	YinghuaZhou	1
RogerS.Barga	MohamedF.Mokbel	1
RichardCole	DennisShasha	1
AlexanderB.Romanovsky	AlanFekete	1
SomnathPal	HimikaBiswas	1
VivekR.Narasayya	ManojSyamala	1
YasuyukiShirai	FumihiroKumeno	1
JohnCieslewicz	JingrenZhou	1
RyuichiIshihara	HidetomoNabeshima	1
DaehyunKim	AnthonyD.Nguyen	1
YiLin	RaghuRamakrishnan	1
XiaoweiSun	BettySalzberg	1
Z.Meral*zsoyoglu	WanhongXu	1
StefanoCeri	AldoBongio	1
PinarSenkul	AhmetCosar	1
KenjiYoshihira	HaifengChen	1
LuisF.Lago-Fern*ndez	FernandoJ.Corbacho	1
PedroCarmona-Saez	A.FazelFamili	1
Wen-SyanLi	VishalS.Batra	2
SureshVenkatasubramanian	BalachanderKrishnamurthy	1
RaviKumar	PrabhakarRaghavan	1
PeterBruza	JingBai	1
PatrickE.O'Neil	AdamBatkin	1
PanagiotisG.Ipeirotis	JunghooCho	1
ThomasKabisch	Jean-LucHainaut	1
MitsuhiroWada	MasayukiTanimoto	1
RaymondJ.Mooney	FosterJ.Provost	1
HongxingHe	DamienMcAullay	1
Jos*Ranilla	ElenaMonta**s	1
YukariShirota	MikaNakaoka	1
SamuelMadden	MichaelStonebraker	2
ThanhTinTang	DavidHawking	1
StevenC.H.Hoi	MichaelR.Lyu	1
VipinGupta	PhilipMaechling	1
KennethA.Ross	JingrenZhou	2
SouravS.Bhowmick	LingChen0002	1
JieYin	JeffreyJunfengPan	1
XiaoyangSeanWang	ChaoYao	1
RyosukeShibasaki	RongXie	1
MatthiasSchubert	KaiYu	1
ChristopheAmbroise	AllouSam*	1
NobuoKawaguchi	KatsunobuItou	1
HetalThakkar	ChangLuo	1
SrinivasanParthasarathy	GregoryBuehrer	1
ThomasB*ck	JoostN.Kok	1
DimitriosGunopulos	CarlottaDomeniconi	1
LouisaNolan	AtaKab*n	1
FrancescoBonchi	FoscaGiannotti	2
MohamedNadif	G*rardGovaert	2
ThienNguyen	KrzysztofKoperski	1
MartinEisenhardt	AndreasHenrich	1
SaraJ.Graves	DavidEmmitt	1
Chotirat(Ann)Ratanamahatana	AdaWai-CheeFu	1
ZhihuaZhang	GangWang	1
Jos*Martinez	HiroshiIshikawa	1
ErhardRahm	DavidAumueller	1
SrikanthSampath	FrancisPang	1
JinyanLi	ChunyuJiang	1
YingLai	WaiGenYee	1
MasatoOguchi	MasaruKitsuregawa	1
TakeshiYamada	KazumasaYamamoto	1
DouglasHolt	BehrokhSamadi	1
JianPei	JianLiu	1
FrancescaCeccherini-Silberstein	Carlo-FedericoPerno	1
Hua-JunZeng	HaoWan	1
SabrinaDeCapitanidiVimercati	PaoloCeravolo	1
IstvanCseri	DenisChurin	1
JianPei	BaileShi	1
ManLeungWong	Kwong-SakLeung	1
SurajitChaudhuri	RajeevMotwani	1
YuxinChen	MarcoCristo	1
StefanoBistarelli	FrancescoBonchi	1
Zolt*nGy*ngyi	HectorGarcia-Molina	1
IsaacChankai	AnnPrestrud	1
MaryRoth	LucianPopa	1
NormenSeemann	BertVanderLinden	1
WeiyiMeng	ShuangLiu	2
MichaelFink	GiovambattistaIanni	1
VenkateshRaghavan	ElkeA.Rundensteiner	1
ElenaV.Samsonova	AdriaanP.IJzerman	1
SusanneE.Hambrusch	ArifGhafoor	1
KotagiriRamamohanarao	JunLiu	1
LukasBlunschi	Jens-PeterDittrich	1
YasuhiroInazumi	YasuhikoFujisaki	1
NanZhang0004	JianerChen	1
ScottLogan	RakeshAgrawal	1
MaddalenaGarzetti	JohnMylopoulos	1
WolfgangNejdl	Paul-AlexandruChirita	1
StanleyB.Zdonik	BradleyBerg	1
StevenGreco	DavidEmmitt	1
PengWang	HaixunWang	1
Woo-CheolKim	Sang-WookKim	1
ManfredHauswirth	KarlAberer	1
YoshiyukiMizuno	SatoshiMori	1
VassilisAthitsos	MichailVlachos	1
HongxingHe	AdaWai-CheeFu	1
Van-NamHuynh	CuongAnhLe	1
VasileiosMegalooikonomou	Chotirat(Ann)Ratanamahatana	1
NataliaIvanova	ErnestSzeto	1
ZografoulaVagena	VittorioCastelli	1
WagnerMeiraJr.	NivioZiviani	1
TakashiTomokiyo	RobertStockton	1
SergeAbiteboul	EllisHorowitz	1
KatsumiTanaka	HiroakiOhshima	1
YuanyuanJia	BruceLambert	1
Jos*AmbrosioToval*lvarez	FranciscoJ.Lucas	1
MarcusFontoura	BeverlyYang	1
YehoshuaSagiv	BennyKimelfeld	1
RichardHull	GiuseppeDeGiacomo	1
VarunKacholia	S.Sudarshan	1
LicesioJ.Rodr*guez-Arag*n	CristinaConde	1
MihoOhsaki	HidenaoAbe	1
J*rgenK.Rockstroh	HaukeWalter	1
StevenGreco	JosephTerry	1
MouradOuzzani	ElisaBertino	1
NaiyaoZhang	LieLu	1
VolkerLinnemann	MartinKempa	1
NgaTran	AdamBatkin	1
ZhengChen	JunYan	2
Sue-ShainWu	GregLiu	1
Hyung-JeongYang	ArnabBhattacharya	1
NaveenAshish	DeniseDraper	1
XiaoyanYu	EdwardA.Fox	1
TimothyMalkemus	BishwaranjanBhattacharjee	1
ManuelMart*n-Merino	AlbertoMu*oz	1
GeorginaRam*rez	ArjenP.deVries	1
G.NiklasNor*n	AndrewBate	1
Marie-ClaudeGaudel	J.EliotB.Moss	1
HaoHe	AdamSilberstein	1
TokWangLing	CheeYongChan	2
SrinivasanParthasarathy	KeithMarsolo	1
JuandeLara	EstherGuerra	1
QuangHieuVu	H.V.Jagadish	1
MihailHalachev	AnandThamildurai	1
Wen-ChiHou	ChengLuo	1
XiangZhang	AnnChristineCatlin	1
TatjanaWelzer-Druzovec	PeterKokol	1
ManaNakano	HaruoYokota	1
JunYan	FengshanBai	1
PhilipS.Yu	JoeMcCloskey	1
Yong-HeeLee	Ji-HoonKang	1
ShinjiroSueda	S.Muthukrishnan	1
SteffenBickel	DavidS.Vogel	1
EvandroBacarin	Andr*Santanch*	1
TakashiWashio	HiroshiMotoda	4
YufeiTao	XiaokuiXiao	1
VolkerMarkl	IvanPopivanov	1
Willem-JanvandenHeuvel	PhilippeThiran	1
MorHarchol-Balter	DavidT.McWherter	1
SayginCelebi	JayasimhaReddyKatukuri	1
FoscaGiannotti	DinoPedreschi	2
Han-ShenHuang	Bou-HoYang	1
NikunjRaghuvanshi	DineshManocha	1
MaurizioMazza	BarbaraCatania	1
DouglasHolt	DanielR.Jeske	1
ThomasKabisch	PhilippeThiran	1
KaranVahi	BrianMendenhall	1
Sang-WonLee	Dong-HyunKim	1
MarcoRuzzi	LucaGrieco	1
YingjiuLi	YingWu	1
HwanjoYu	ChaoLiu0001	1
MaureenDougherty	HansChalupsky	1
YufeiTao	ManLungYiu	2
EricK.Ringger	AnthonyAue	1
MariosHadjieleftheriou	GeorgeKollios	2
XiaofangZhou	BengChinOoi	1
StellaLuk	MohammadEl-Hajj	1
KaushalSanghai	DavidR.Kaeli	1
Tze-YunLeong	PohsanLai	1
NikoBeerenwinkel	MartinD*umer	1
P*velCalado	MarcoCristo	1
TharamS.Dillon	BenSoh	1
GaganAgrawal	ChaoWang	1
YingXing	AnuragMaskey	1
DiveshSrivastava	Am*lieMarian	2
TakehiroFurudate	ReijiTeramoto	1
JoshuaO'Madadhain	JonHutchins	1
NadavEiron	ChavdarBotev	1
OrkutBuyukkokten	EllenSpertus	1
MichaelJ.Carey	AlonY.Halevy	1
MatthiasBrantner	Carl-ChristianKanne	2
VolkerMarkl	UtkarshSrivastava	1
ShinjiShimojo	KentaroWakatsuki	1
MayaRamanath	LingzhiZhang	1
MaguelonneTeisseire	DominiqueLaurent	1
SujataBanerjee	AlexandrosLabrinidis	1
Rog*riodeLemos	GerhardWeikum	1
MarcosAndr*Gon*alves	AlexandreX.Falc*o	1
TokWangLing	TianYu	1
YanjiangYang	ElisaBertino	1
DenilsonBarbosa	AlbertoO.Mendelzon	1
HaoHe	HaiYu	1
NorihideKitaoka	KazumasaYamamoto	1
ToddC.Mowry	PhillipB.Gibbons	1
PeterA.C.'tHoen	AllanTucker	1
TimothyEdmunds	SubarnaSadhukhan	1
HuimingQu	ChristosFaloutsos	2
ScottOster	RenatoFerreira	1
ArnabBhattacharya	AmbujK.Singh	1
Wen-ChiehYang	Ming-SyanChen	1
RafalRak	Maria-LuizaAntonie	1
ThomasBehr	MarkusSpiekermann	1
NelsonF.F.Ebecken	DeborahR.Carvalho	1
RachelPottinger	KennethA.Ross	1
KevinS.Beyer	BrianVickery	1
TsuyoshiId*	TakahideNogayama	1
VictorVianu	SergeAbiteboul	1
SotirisBrakatsoulas	NectariaTryfona	1
BaopingZhang	AlexandreX.Falc*o	1
StefanManegold	PeterA.Boncz	1
WeiHong	FangBian	1
NaZhao	Mei-LingShyu	1
VijayKumar	AlexandrosLabrinidis	1
VasileiosMegalooikonomou	LonginJanLatecki	1
WojciechSzpankowski	RobertGwadera	1
TerenceHo	AngelaBonifati	1
VarunPandey	ChrisBailey-Kellogg	1
NicolaLeone	MarcoRuzzi	1
VishalSikka	JeffPollock	1
M.Tamer*zsu	ChristianS.Jensen	2
PhilippeThiran	JeanHenrard	1
ZhimaoGuo	AoyingZhou	1
MatthewSiegler	KamalNigam	1
JeffreyXuYu	AoyingZhou	1
MitchCherniack	AlexRasin	1
ToshikiEndo	ShingoKuroiwa	1
YiZhang0006	W.NickStreet	2
CarlKesselman	BrianMendenhall	1
NikunjRaghuvanshi	NagaK.Govindaraju	1
Hans-ArnoJacobsen	HaifengLiu	1
TranTrang	HoangNgocMinh	1
VarunKacholia	RushiDesai	1
YutakaYanagisawa	HidetoshiKido	1
PeterBuneman	ByronChoi	1
ShaofengBu	LaksV.S.Lakshmanan	1
VojkanMihajlovic	DjoerdHiemstra	1
MikaelFortelius	HeikkiMannila	1
QiGuo	JingSun	1
BlazZupan	AleksJakulin	1
EugeneJ.Shekita	ChavdarBotev	1
KatsuyukiSawai	HiroshiSaruwatari	1
ZhengChen	FengshanBai	1
XiangZhang	ChristopherW.Clifton	1
HansChalupsky	GaurangMehta	1
NematollaahShiri	AnandThamildurai	1
GiovambattistaIanni	BartoszNowicki	1
LucianPopa	LauraM.Haas	1
JianshuWeng	DongtaoLi	1
GiovambattistaIanni	GianluigiGreco	1
ArifGhafoor	AnnChristineCatlin	1
WeiYu	MichaelRys	1
SugataGhosal	AkshatVerma	1
ShirohHoribe	HiroshiTakegawa	1
JavierSegovia	ErnestinaMenasalvasRuiz	1
PhilipMaechling	EwaDeelman	1
LinQiao	DivyakantAgrawal	2
JayantKalagnanam	AmitJ.Shah	1
Yong-HeeLee	Min-WooLee	1
RobertLyle	GeorgeLapis	1
VassilisJ.Tsotras	GeorgeKollios	1
MasanoriArita	HiroyukiOka	1
WalidA.Najjar	VanaKalogeraki	1
Rog*riodeLemos	BrianRandell	1
VincenzinoLio	GiovambattistaIanni	1
SpirosPapadimitriou	AristidesGionis	2
JoonhoKwon	BongkiMoon	1
YaqinWang	Fang-zhongSu	1
WeiYu	BrandonBerg	1
SrikantaTirthapura	PavanAduri	1
JingSun	JianhuaFeng	1
RobertAtlas	JosephTerry	1
M.Tamer*zsu	LeiChen0002	2
WenJin	MartinEster	2
YunyaoLi	HuahaiYang	1
AlexRasin	AdamBatkin	1
Jos*AmbrosioToval*lvarez	ErnestoPimentel	1
MarkHumphrey	AlexRasin	1
Per-*keLarson	DavidDeHaan	1
JayasimhaReddyKatukuri	DheerendranathMundluru	1
ZhuoweiLi	JianyingZhou	1
XiaohuiLiu	VeronicaVinciotti	1
SergeyMelnik	AlonY.Halevy	1
Pui-yingTang	Chak-manNg	1
OlgaPapaemmanouil	MarkHumphrey	1
ElaineQingChang	AngelaBonifati	1
RamanathanV.Guha	AndrewTomkins	1
RicardodaSilvaTorres	MarcosAndr*Gon*alves	1
MichalisVazirgiannis	MariaHalkidi	1
SadokBenYahia	EngelbertMephuNguifo	1
GaurangMehta	EwaDeelman	1
GerhardWeikum	AnjaTheobald	1
WenfeiFan	HongjunLu	1
YongluanZhou	AoyingZhou	1
MichaelStonebraker	JoachimHammer	1
Y*celSaygin	Ay*aAzginHintoglu	1
YoshikiNinomiya	MinekiSoga	1
KrithiRamamritham	CliffB.Jones	1
Tom*sSkopal	JaroslavPokorn*	1
SugatoBasu	RaymondJ.Mooney	1
TakaoMiura	KouTakahashi	1
GianlucaIannaccone	FangBian	1
PeterZ.Revesz	BartKuijpers	1
IreneD*az	El*asF.Combarro	1
ZhenZhang	BinHe	3
H*ctorAllende	ClaudioMoraga	1
IvyTong	BenKao	1
WenyuanLi	WeeKeongNg	1
TakanobuNishiura	ShingoKuroiwa	1
Ming-ChuanWu	Jos*A.Blakeley	1
MasatoKitajima	GenKawamura	1
RogerS.Barga	DavidB.Lomet	1
TaniaCerquitelli	ElenaBaralis	1
WanxiaXie	ShamkantB.Navathe	1
RiccardoRosati	EdytaKalka	1
RahulRamachandran	Juan-CarlosJusem	1
OlgaPapaemmanouil	AnuragMaskey	1
Ren*eJ.Miller	MehediMasud	1
SebastianMichel	MatthiasBender	1
SongWang	MuraliMani	1
GangWu	EdwardY.Chang	2
Mohand-SaidHacid	JianpingFan	2
RonaldFagin	PhokionG.Kolaitis	1
TonjeStrommenSteigedal	AstridL*greid	1
EnriqueCabello	*ngelSerrano	1
XinChen	RazvanStefanBot	2
PhilipS.Yu	BamshadMobasher	1
OktieHassanzadeh	MortezaMonemizadeh	1
ZografoulaVagena	VassilisAthitsos	1
SutanuChakraborti	NirmalieWiratunga	1
ShlomoHershkop	SalvatoreJ.Stolfo	1
GustavoAlonso	FabioCasati	1
GiulianoTirenni	CesarBerrospi	1
JulienBlanchard	HenriBriand	1
KateA.Smith	DavidTaniar	1
XueminLin	JeffreyXuYu	2
ZacharyG.Ives	ChristianS.Jensen	1
TonjeStrommenSteigedal	AmundTveit	1
YufeiTao	DimitrisPapadias	3
NikosMamoulis	HuipingCao	1
SvenHelmer	GuidoMoerkotte	2
JianfengGao	BinggongDing	1
Mih*lyJakob	MatthiasGro*mann	2
GeYu	DalingWang	1
Marie-ClaudeGaudel	KrithiRamamritham	1
RiccardoMartoglia	FedericaMandreoli	1
Jian-TaoSun	JeffreyJunfengPan	1
OphirFrieder	DavidA.Grossman	1
TaeHoKang	SeokIlSong	1
HeikoSchuldt	CanT*rker	1
StephenBalakirsky	ChrisScrapper	1
VladislavShkapenyuk	ChristopherOlston	1
ThomasH*se	DirkAnsorge	1
ThomasEiter	RiccardoRosati	1
VojkanMihajlovic	PeterM.G.Apers	1
MaryE.Edgerton	LianhongTang	1
ElisaBertino	ElenaFerrari	2
MoninderSingh	AmitJ.Shah	1
SunilPrabhakar	MouradOuzzani	1
PanagiotisG.Ipeirotis	AlexandrosNtoulas	1
KenjiYoshihira	GuofeiJiang	1
ShuigengZhou	JoshuaZhexueHuang	1
XingquanZhu	XindongWu	2
ZacharyG.Ives	DavidJ.DeWitt	1
XuelongLi	XindongWu	1
PeterM.G.Apers	HenkErnstBlok	1
MarkLevene	Jos*Borges	1
XueminLin	HongjunLu	3
Jos*Ranilla	IreneD*az	1
RasmusKaae	DennisN*rgaard	1
WeiWang0010	SusanPaulsen	1
LeiLiu	AnthonyK.H.Tung	1
SonN.Nguyen	MariaE.Orlowska	2
RuomingJin	GaganAgrawal	3
SaileshKrishnamurthy	NathanBurkhart	1
StephenC.Gates	Keh-ShinF.Cheng	1
WenjuanXing	OlgaPapaemmanouil	1
SimonChong	MichaelHitchens	1
YingXing	MarkHumphrey	1
DenilsonBarbosa	AdrianM.Teisanu	1
J.D.Garc*aLuna	A.Est*vezGarc*a	1
YiHuang	VolkerTresp	1
WalidG.Aref	MohamedG.Elfeky	1
Tat-SangChoy	SteveBarr	1
MartinLorenz	IngoJ.Timm	1
M.Tamer*zsu	AndreasHeuer	2
TakashiKobayashi	HaruoYokota	1
PeterA.Boncz	JensTeubner	1
QuamrulI.Khan	CarsonKai-SangLeung	1
MohamedG.Elfeky	AhmedK.Elmagarmid	1
NingLi	MarcusFontoura	1
DavidJ.DeWitt	AlexanderS.Szalay	1
YiHuang	ShipengYu	1
ShutingXu	JunZhang	1
PengLiu	DikLunLee	1
MichelangeloCeci	AnnalisaAppice	1
MuralidharKrishnaprasad	JamesW.Warner	1
KshirasagarNaik	GordonB.Agnew	1
ThomasLengauer	GerdF*tkenheuer	1
NorbertoD*az-D*az	Jes*sS.Aguilar-Ruiz	1
MagdalenaBalazinska	AlexRasin	1
YufeiTao	MariosHadjieleftheriou	1
SrikanthSampath	AnupamSingh	1
JanD.Gehrke	HagenLanger	1
JingPeng	ChangjieTang	1
YingZhang	JianChu	1
JianXu	ChenWang	1
YingXing	AlexRasin	1
TedYounglove	RyanRich	1
KunalPunera	JoydeepGhosh	1
MengchiLiu	GuorenWang	1
MarcoRuzzi	BartoszNowicki	1
TuongC.Truong	RobertLyle	1
Ming-SyanChen	Kun-TaChuang	4
NorihideKitaoka	KazuyaTakeda	1
TahsinM.Kur*	ShannonHastings	1
Kuo-ZuiLin	Chia-HuiChang	1
SadokBenYahia	JihemRezgui	1
Ming-HsiangWang	Ja-HwungSu	1
NesimeTatbul	AnuragMaskey	1
SaneyasuYamaguchi	KikukoKamisaka	1
MartinLorenz	JanD.Gehrke	1
StratisViglas	RobertHutchison	1
WitoldStaniszkis	MichaelFink	1
XiaodanSong	BelleL.Tseng	1
MasaruKitsuregawa	BotaoWang	1
LeefengChien	FengshanBai	1
PhilipBohannon	P.P.S.Narayan	1
Kyu-YoungWhang	ByungSukLee	1
SuryaNepal	AlanFekete	1
LiangxiaoJiang	HarryZhang	2
XueminLin	QingZhang	1
ZhengdingLu	YiqunHuang	1
JianliangXu	BaihuaZheng	1
JulienBlanchard	FabriceGuillet	1
WeiWang0011	QingLiu	1
MarkR.Verardo	ArnabBhattacharya	1
JenniferWidom	HolgerMeyer	1
MasakiyoFujimoto	KazumasaYamamoto	1
MichiharuKudo	HamidPirahesh	1
HeikkiMannila	ChristosFaloutsos	1
MarkA.Hall	MarcSumner	1
TanuMalik	AmitabhChaudhary	1
Yi-fangBrookWu	QuanzhiLi	2
YolandaGil	PhilipMaechling	1
Ren*eJ.Miller	MaddalenaGarzetti	1
TovaMilo	CatrielBeeri	1
MarkOette	HaukeWalter	1
PedroBizarro	DavidJ.DeWitt	3
CliffB.Jones	BrianRandell	1
YiChen	SusanB.Davidson	1
XinXu	BengChinOoi	1
TilmannF.W.Bruckhaus	CharlesX.Ling	1
ToshihiroKoma	Md.Altaf-Ul-Amin	1
RistoA.V*is*nen	AristidesGionis	1
YongtaiZhu	WeiWang0009	1
Wei-kengLiao	AlokN.Choudhary	1
SusanneE.Hambrusch	JeffreyScottVitter	1
Rog*rioLu*sdeCarvalhoCosta	MarcosAntonioVazSalles	1
Rog*riodeLemos	DavidB.Lomet	1
SusanneE.Hambrusch	ElisaBertino	1
PradeepDubey	DaehyunKim	1
ShenjieLi	JunXu	1
MosheKoppel	KfirZigdon	1
NickKoudas	DiveshSrivastava	8
KaushikSinha	GaganAgrawal	1
MarkR.Verardo	ChristosFaloutsos	1
StavrosHarizopoulos	AnastassiaAilamaki	1
GiovambattistaIanni	EdytaKalka	1
SriramPadmanabhan	LeslieCranston	1
MichaelK.Ng	KevinY.Yip	2
TilmannF.W.Bruckhaus	NazimH.Madhavji	1
VishalSikka	NaveenAshish	1
Marie-ChristineRousset	AlexandreTermier	1
RakeshAgrawal	JerryKiernan	1
OmidMadani	GiridharKumaran	1
NgaTran	DanielJ.Abadi	1
HamidPirahesh	BertVanderLinden	1
JiYoungWoo	ChongUnPyon	1
TaneliMielik*inen	PanayiotisTsaparas	1
ValentinaSvicher	MartinD*umer	1
GarrickStaples	EwaDeelman	1
YueZhao	JihongGuan	1
JavierSegovia	*scarCubo	1
Ugur*etintemel	StanleyB.Zdonik	3
ElkeAchtert	ChristianB*hm	1
YoshinobuYamashita	MamoruHoshi	1
IanC.MacMillan	AdrianBecker	1
RaviRajwar	AlexanderB.Romanovsky	1
MariaHalkidi	CarlottaDomeniconi	1
ToyohideWatanabe	MasakazuIkezaki	1
LiWei	AgenorMafra-Neto	1
GerhardWeikum	DavidB.Lomet	1
YanHuang	LiqinZhang	1
TakeshiYamada	TakanobuNishiura	1
SugatoBasu	ArindamBanerjee	1
WeiWang0010	JiongYang	1
AnuragMaskey	AlexRasin	1
LaurentAmsaleg	Bj*rn**rJ*nsson	2
ThomasSeidl	MarkusPeters	1
TsuyokiNishikawa	DaisukeSaitoh	1
MaurizioLenzerini	DomenicoLembo	1
Kian-LeeTan	AoyingZhou	1
RaghuRamakrishnan	PrasadDeshpande	1
SusanneE.Hambrusch	SunilPrabhakar	1
YanHuang	PingYu	1
YinghuaZhou	ChuangWang	1
Fatma*zcan	ChunZhang	1
VictorTeixeiradeAlmeida	FrankHoffmann	1
GhadaGasmi	EngelbertMephuNguifo	1
ThomasR*lleke	SihemAmer-Yahia	1
KunHuang	*mitV.*ataly*rek	1
StefanoLonardi	EamonnJ.Keogh	2
WataruUchida	ShojiroNishio	1
MarcPlantevit	MaguelonneTeisseire	1
VanjaJosifovski	ChunZhang	2
RamanathanV.Guha	DanielGruhl	1
VanjaJosifovski	BeverlyYang	1
VincenzinoLio	MarcoRuzzi	1
RonaldFagin	AndrewTomkins	1
SabrinaDeCapitanidiVimercati	PierangelaSamarati	1
Sa*daMedjdoub	PhilippePucheral	1
TranHuyDat	KazuyaTakeda	1
R*gisSaint-Paul	NoureddineMouaddib	1
KrishnaPalaniappan	FrankKorzeniewski	1
AtsuyukiMorishima	AkiyoshiNakamizo	1
ManfredHauswirth	AnwitamanDatta	1
PhilipS.Yu	HaixunWang	7
KevinS.Beyer	JayavelShanmugasundaram	1
Wen-ChiHou	QiangZhu	1
JamesE.Dobson	IanT.Foster	1
KanghengWu	DouShen	1
KennyDaniel	AndrewW.Moore	1
WilliamH.Milnor	CarticRamakrishnan	1
ElioLozano	EdgarAcu*a	1
MitsuhikoOhta	MinekiSoga	1
SwaroopK.Chalasani	JayantKalagnanam	1
JunYang0001	HaixunWang	1
GuihongCao	DaweiSong	1
XinLi	ChristopheDiot	1
CristianaAmza	AlanL.Cox	1
TonyGriffiths	NassimaDjafri	1
Kyu-YoungWhang	JenniferWidom	1
Jos*Crist*balRiquelmeSantos	Jes*sS.Aguilar-Ruiz	1
YunhuaHu	DmitriyMeyerzon	1
GianluigiGreco	AntonellaGuzzo	1
JinhuiYuan	FuzongLin	1
JiaweiHan	ChaoLiu0001	1
TruH.Cao	CaoD.Nguyen	1
HolgerMeyer	BirgerH*nsel	1
PrabhakarRaghavan	AndrewTomkins	1
RandallSalas	CarolaWenk	1
ToshikiEndo	SatoshiNakamura	1
PierreGeurts	LouisWehenkel	1
MukeshK.Mohania	BhuvanBamba	2
ShashankPandit	S.Sudarshan	1
ThomasA.Russ	MaureenDougherty	1
ShoheiHido	HiroyukiKawano	1
WeiWang0009	BaileShi	4
RaduStefanNiculescu	R.BharatRao	1
YiDing	XueLi	1
ZijianZheng	Honghua(Kathy)Dai	1
RyoHirade	HisashiKashima	1
ClaudiaPerlich	BiancaZadrozny	1
Hans-PeterKriegel	AlexeyPryakhin	2
UlrichKreher	PeterDadam	1
SungRanCho	NickKoudas	1
LaurentMignet	DenilsonBarbosa	1
SatokoFujisawa	Fr*d*ricAndr*s	1
StevenMinton	ClaudeNanjo	1
WojciechStach	Maria-LuizaAntonie	1
DavidJ.Haglin	AnnaM.Manning	1
PeterA.Tucker	KristinTufte	2
StephenBay	PhilipChan	1
IstvanCseri	BrandonBerg	1
MasakiyoFujimoto	ChiyomiMiyajima	1
PatrickGallinari	Massih-RezaAmini	1
SangKyunCha	AnastassiaAilamaki	1
Fu-ChiehYu	Chih-HungHsieh	1
KaranVahi	HansChalupsky	1
TimothyEdmunds	S.Muthukrishnan	1
MouniaLalmas	AnastasiosTombros	1
ElenaFerrari	BarbaraCarminati	3
ThomasTakeoOsugi	StephenD.Scott	1
SriharshaVeeramachaneni	EmanueleOlivetti	1
SurajitChaudhuri	ArunprasadP.Marathe	1
TakahiroKosaka	SusumuDate	1
Denny	DavidMcG.Squire	1
KazutoYamazaki	HideoMatsuda	1
EvangelosKanoulas	DonghuiZhang	1
JanderMoreira	AlanGavioli	1
ShreeRaman	BhuvanBamba	1
Rog*riodeLemos	Lu*sRodrigues	1
NatalieS.Glance	MatthewSiegler	1
TorstenGrabs	LourensVeen	1
YunyaoLi	H.V.Jagadish	1
Yi-PingPhoebeChen	SupawanPrompramote	1
MaureenDougherty	GaurangMehta	1
RalfSchenkel	AnjaTheobald	1
VasileiosMegalooikonomou	EamonnJ.Keogh	1
Kwok-YanLam	Hua-JunZeng	1
VincenzinoLio	RiccardoRosati	1
JiankuiGuo	BeijunRuan	1
YukariShirota	KatsumiTanaka	1
NingZhang0002	ChunZhang	1
Wei-YingMa	Tie-YanLiu	2
HenryF.Korth	CliffB.Jones	1
TsuyoshiId*	KeisukeInoue	1
UlrichThiel	LiboChen	1
DonaldD.Chamberlin	DanielaFlorescu	1
DavidT.McWherter	AnastassiaAilamaki	1
DavidT.Liu	DavidJ.DeWitt	1
LonginJanLatecki	Chotirat(Ann)Ratanamahatana	2
RossSparks	DamienMcAullay	1
SongboTan	BinWang	1
ShobhitMathur	BhushanMandhani	1
ReynoldCheng	AlanKwan	1
GiovambattistaIanni	DomenicoLembo	1
QuocLe	HoaNguyen	1
KenQ.Pu	AlbertoO.Mendelzon	1
SriharshaVeeramachaneni	FrancescaDemichelis	1
MihirShah	JingrenZhou	1
KiyohiroShikano	KatsuyukiSawai	1
BenKao	AlanKwan	1
MichaelFink	GianluigiGreco	1
SheilaA.Greibach	EllisHorowitz	1
StevenGreco	SaraJ.Graves	1
Ghazi-NourdineBenadjaoud	BharatRane	1
TakashiTomii	HiroyukiNasu	1
ShaluGupta	RadaChirkova	1
RobertAtlas	RahulRamachandran	1
NitinKumar	DimitriosGunopulos	1
YoshiyukiMizuno	MichimasaItoh	1
ParkeGodfrey	CalistoZuzarte	1
PrasanRoy	BhuvanBamba	2
RahulRamachandran	DavidEmmitt	1
GerhardWeikum	BrianRandell	1
YanpingZhang	LingZhang	1
JiangSu	HarryZhang	1
Xu-binDeng	NingShang	1
WeiWang0009	JiaweiHan	1
JenniferNeville	DavidJensen	2
XinLi	GianlucaIannaccone	1
NataliaIvanova	FrankKorzeniewski	1
NikoBeerenwinkel	FrancescaCeccherini-Silberstein	1
WeiFan	FeiTonyLiu	1
PetkoBakalov	GeorgeKollios	1
YasushiOgawa	HirokoMano	1
Wolf-TiloBalke	UlrichG*ntzer	1
UlrichThiel	PeterFankhauser	1
TimothyChorma	SeemaSundara	1
ManabuOhta	HiroshiIshikawa	1
MorHarchol-Balter	BiancaSchroeder	1
WarrenShen	OluSobulo	1
TakuKudo	TakahikoIto	1
VictorVianu	DayouZhou	1
ElizabethJ.O'Neil	EdmondLau	1
NitinKumar	Chotirat(Ann)Ratanamahatana	1
JingPeng	CostinBarbu	1
MartinTheobald	DimitriosMavroeidis	1
JunAdachi	AtsuhiroTakasu	1
ShuangLiu	DavidA.Grossman	1
SushilJajodia	ChaoYao	1
RajkumarBuyya	JiaYu	1
ViswanathanKrishnamurthy	NipunAgarwal	1
SaraJ.Graves	JosephTerry	1
EugeneKogan	BrandonBerg	1
JingdanZhang	GuodongLiu	1
WenjuanXing	Jeong-HyonHwang	1
SamKwong	Chi-HoTsang	1
VipinKumar	MichaelSteinbach	2
StephenD.Scott	KunDeng	1
NathanBurkhart	MichaelJ.Franklin	1
S.S.Ravi	IanDavidson	2
GiuseppeManco	DomenicoSacc*	1
YasuyukiShirai	Shin'ichiKobayashi	1
GurmeetSingh	BrianMendenhall	1
Mich*leSebag	HiroshiMotoda	1
MartinMozina	IvanBratko	1
FrancisPang	BharatRane	1
StanleyB.Zdonik	AlexRasin	3
Willem-JanvandenHeuvel	JohanPetrini	1
BrunoCr*milleux	ArnaudSoulet	2
GeorgeLapis	Fatma*zcan	1
J.GregorySteffan	ChristopherB.Colohan	1
RobertMcCann	BedoorK.AlShebli	1
SrinivasanParthasarathy	AmolGhoting	1
EdwardL.Robertson	CatharineM.Wyss	1
JiaweiHan	BaileShi	1
Ugur*etintemel	AlexRasin	2
XiaohuiYu	KennethC.Sevcik	1
SatoshiNakamura	MitsunoriMizumachi	1
Seung-wonHwang	HwanjoYu	1
YingChen	FrankK.H.A.Dehne	1
SihemAmer-Yahia	IriniFundulaki	1
NgaTran	MichaelStonebraker	1
YaserS.Abu-Mostafa	AmritPratap	1
NigelEllis	BalajiRathakrishnan	1
SatoshiMori	MichimasaItoh	1
Bj*rnBringmann	AlbrechtZimmermann	2
SanjayAgrawal	ArunprasadP.Marathe	1
JihadBoulos	DanSuciu	1
DanieleGunetti	ClaudiaPicardi	1
YaboXu	RongShe	2
MichaelShneier	CraigSchlenoff	1
ValentinaSvicher	KlausKorn	1
KevinS.Beyer	JoshuaHui	1
Mohand-SaidHacid	FabienDeMarchi	1
ThomasH*se	MarkusSpiekermann	1
JinzeLiu	AndrewB.Nobel	1
KazuhitoKobayashi	HaruoYokota	1
PatrickE.O'Neil	AmersonLin	1
XiaoyanYu	FernandoA.DasNeves	1
ShiyongLu	DapengLiu	1
SugataGhosal	RohitJain	1
JimMelton	AndrewEisenberg	1
XueqiCheng	MoustafaGhanem	1
DinaBitton	DeniseDraper	1
SheilaA.Greibach	DanielJ.Rosenkrantz	1
Shen-TatGoh	Kian-LeeTan	1
YuelongJiang	AlexanderTuzhilin	1
TapioPahikkala	AleksandrMyll*ri	1
SeokJaeLee	SeokIlSong	1
DavidB.Lomet	AlanFekete	1
VadirajaBhatt	PhilShaw	1
DinaBitton	AlonY.Halevy	1
PadhraicSmyth	JoshuaO'Madadhain	1
BrianRandell	AlanFekete	1
XuedongChen	SamuelMadden	1
XiangZhang	JeffreyScottVitter	1
SteveBarr	JohnWilkins	1
VolkerTresp	Hans-PeterKriegel	2
SpiridonBakiras	PanosKalnis	1
PierangelaSamarati	ErnestoDamiani	1
JihieKim	HansChalupsky	1
Yen-KuangChen	DaehyunKim	1
SwaroopK.Chalasani	SudhirVerma	1
S.Muthukrishnan	OliverSpatscheck	1
PatrickPantel	MarkoGrobelnik	1
WeiguoFan	P*velCalado	2
MarianaJbantova	ElkeA.Rundensteiner	2
LiseGetoor	LisaSingh	1
RistoA.V*is*nen	HeikkiMannila	1
MitsunoriMizumachi	MasakiyoFujimoto	1
VassilisPapadimos	DavidMaier	2
R.BharatRao	MuratDundar	1
ZiyingLiu	PedroCarmona-Saez	1
NihanKesimCicekli	IsmailHakkiToroslu	1
MauricioA.Hern*ndez	LucianPopa	1
SuminSong	ChengkaiLi	1
SanghyunPark	Jung-ImWon	2
PeterA.Flach	EliasGyftodimos	1
StefanoLonardi	AnthonyJ.Bagnall	1
KeYi	AdamSilberstein	1
YufeiTao	SunilPrabhakar	1
RyanRich	BehrokhSamadi	1
XueminLin	JianzhongLi	1
SusumuAkamine	HirokiArimura	1
KoutarouNakanishi	HiroshiMotoda	1
XingzhiSun	PhilipS.Yu	1
MoChen	Kwok-YanLam	1
RolfLak*mper	QiangWang	2
MayaRamanath	JulianaFreire	1
HuiZhang	GangWang	1
ShankarPal	MichaelRys	1
GerdF*tkenheuer	Carlo-FedericoPerno	1
LicesioJ.Rodr*guez-Arag*n	EnriqueCabello	1
HiroyukiKitagawa	ChristosFaloutsos	1
MarkR.Verardo	Jia-YuPan	1
TadashiTsumura	HiroakiEtoh	1
FaridParvini	CyrusShahabi	1
KennethA.Ross	JohnCieslewicz	1
VassilisAthitsos	MariosHadjieleftheriou	1
OluSobulo	AlexanderKramnik	1
WenfeiFan	StratisViglas	1
ZunpingCheng	Fang-zhongSu	1
AnirbanDasgupta	AndrewTomkins	1
MamoruHoshi	GuanghaoLi	1
WitoldStaniszkis	GiorgioTerracina	1
TakashiKobayashi	SatoshiNaoi	1
DanielR.Jeske	BehrokhSamadi	1
RandalC.Burns	AmitabhChaudhary	1
MichaelJ.Franklin	AlonY.Halevy	1
MaheshkumarSabhnani	KennyDaniel	1
Jia-JinLe	DimitriosGunopulos	1
VanjaJosifovski	GeorgeLapis	1
JayantMadhavan	AlonY.Halevy	3
Willem-JanvandenHeuvel	Jean-LucHainaut	1
YiLin	Bee-ChungChen	1
ZhengjieZhang	JeffreyXuYu	1
MagdalenaBalazinska	Jeong-HyonHwang	1
RichardT.Snodgrass	JenniferWidom	1
RobertaCochrane	Fatma*zcan	1
JimKleewein	Fatma*zcan	1
S*rgioLifschitz	AlbertoH.F.Laender	1
StevenM.Beitzel	AbdurChowdhury	1
WeifengLi	FumitadaItakura	1
MitchCherniack	MiguelFerreira	1
S.Muthukrishnan	MinosN.Garofalakis	1
S.Muthukrishnan	GrahamCormode	4
YaliZhu	BinLiu	1
ZhengxuanWang	WanliZuo	1
VolkerTresp	KaiYu	2
XifengYan	PhilipS.Yu	2
RobertLyle	KevinS.Beyer	1
ToshiakiOkawara	Ken'ichiIshikawa	1
Kian-LeeTan	HweeHwaPang	2
MarcSpraragen	GaurangMehta	1
HaixunWang	BaileShi	1
J*rgenK.Rockstroh	DanielHoffmann	1
SudhirP.Mudur	NematollaahShiri	1
MarcW*rlein	IngridFischer	1
MaurizioLenzerini	GiorgioTerracina	1
Ugur*etintemel	MagdalenaBalazinska	1
JohnShepherd	AnneH.H.Ngu	1
Young-HoPark	Kyu-YoungWhang	1
JongHyunPark	Byung-KyuKim	1
SourashisRoy	RobertAdams	1
KiyoungYang	CyrusShahabi	2
MaartenMarx	JaapKamps	1
VincenzinoLio	DomenicoLembo	1
ShankarPal	BrandonBerg	1
GrahamCormode	FlipKorn	1
RunaBhaumik	ChadWilliams	2
YingXing	YanifAhmad	1
Wen-SyanLi	K.Sel*ukCandan	1
JimGray	GerdHeber	1
StefanoCeri	AlessandroCampi	1
TakashiWashio	Mich*leSebag	1
TerranLane	StephenBay	1
TahsinM.Kur*	*mitV.*ataly*rek	1
AristidesGionis	AlexanderHinneburg	1
TheodoreDalamagas	AntonisKoufopoulos	1
YokoKamidoi	NoriyoshiYoshida	1
RuiWang0002	DavidB.Lomet	1
JieChen	GrahamJ.Williams	1
VolkerHeun	JohannesFischer	1
SharmaChakravarthy	QingchunJiang	1
YuQian	D.T.Huynh	1
Jos*deJes*sP*rezAlc*zar	EvandroBacarin	1
ChristopherBesemann	AnneDenton	1
GregorLeban	BlazZupan	1
PieroFraternali	AldoBongio	1
KeWang	AlexanderTuzhilin	1
ThomasEiter	MaurizioLenzerini	1
QiangYang	DouShen	1
SharmaChakravarthy	ManuAery	1
J.Padr*nLorenzo	A.Est*vezGarc*a	1
NingLi	JoshuaHui	1
YutakaKatsuyama	YutaOchi	1
LiChen	AmarnathGupta	2
SergeAbiteboul	NicoletaPreda	1
PaoloAvesani	EmanueleOlivetti	1
MemaRoussopoulos	MattWelsh	1
ShetalShah	ChinyaV.Ravishankar	1
MichaelWatzke	JeffreyF.Naughton	1
ZhimingDing	DirkAnsorge	1
YuhongYan	DanielLemire	1
VictorVianu	AlinDeutsch	1
YoshikiNinomiya	MitsuhikoOhta	1
YoshikoItabashi	YoshifumiMasunaga	1
ScottWhite	PadhraicSmyth	1
MichaelGamon	AnthonyAue	1
PascalPoncelet	Jean-EmileSymphor	1
ZhihuaChen	LianhongTang	1
SrujanaMerugu	JoydeepGhosh	1
WitoldStaniszkis	VincenzinoLio	1
XiaochenWu	WeiWang0009	1
Wen-ChiHou	FengYan	1
MohamedF.Mokbel	IbrahimKamel	1
PinarSenkul	IsmailHakkiToroslu	1
TaeHoKang	SeokJaeLee	1
S.Muthukrishnan	DiveshSrivastava	1
RussellGreiner	Chi-HoonLee	1
JamesElding	J*rgSander	1
PhilippR*sch	ErikBuchmann	1
RonHoory	AlexeyRoytman	1
StavrosPolyviou	ParaskevasEvripidou	1
ShantanuJoshi	AlinDobra	2
MarkOette	J*rgenK.Rockstroh	1
Jos*Iborra	IsidroRamos	1
ToshinariIida	AkiyoshiNakamizo	1
RaviRajwar	GerhardWeikum	1
ZhengShao	DengCai	1
MaartenMarx	B*rkurSigurbj*rnsson	1
XinLi	RamakrishnaGummadi	1
YanifAhmad	BradleyBerg	1
XuanZhou	Kian-LeeTan	1
ShrikanthShankar	LeiSheng	1
MichaelStonebraker	DanielJ.Abadi	1
KrishnaPalaniappan	ErnestSzeto	1
SameepMehta	RaghuMachiraju	1
NicholasLester	AlistairMoffat	1
TranHuyDat	FumitadaItakura	1
ChadWilliams	BamshadMobasher	2
DavidW.Cheung	BenKao	1
VijayshankarRaman	AlbertoLerner	1
JieChen	AdaWai-CheeFu	1
SebastianH.R.Wurst	PeerKr*ger	1
JingGao	JianzhongLi	1
TsutomuTerada	HidekazuMatsunam	1
LicesioJ.Rodr*guez-Arag*n	*ngelSerrano	1
MaurizioLenzerini	EdytaKalka	1
MichaelFink	MarcoRuzzi	1
RobertA.Stine	JingZhou	1
Hyung-JuCho	Chin-WanChung	1
LipyeowLim	JeffreyScottVitter	1
DmitriiPolshakov	ChaoWang	1
PraveenRao	BongkiMoon	1
ChristopherW.Clifton	AhmedK.Elmagarmid	1
Lu*sRodrigues	DavidB.Lomet	1
WeiHan	K.Sel*ukCandan	1
LucianoA.Digiampietri	EdmundoRobertoMauroMadeira	1
OsmarR.Za*ane	MyraSpiliopoulou	1
RadaChirkova	JunYang	1
DouglasStottParkerJr.	CarloZaniolo	1
GuidoMiraglia	GiuseppeDeNicolao	1
TakeoKato	MitsuhikoOhta	1
TahsinM.Kur*	JoelH.Saltz	1
YaqinWang	Xu-binDeng	1
YolandaGil	HansChalupsky	1
SaneyasuYamaguchi	MasaruKitsuregawa	1
MelanieWeis	KarstenDraba	1
KazuyaTakeda	FumitadaItakura	2
RyoTaguchi	ManaNakano	1
ThijsWesterveld	ArjenP.deVries	1
TyroneGrandison	ScottLogan	1
ZhaoHuiTang	YunboCao	1
WangChiewTan	GauravVijayvargiya	1
EamonnJ.Keogh	AnthonyJ.Bagnall	1
JiaweiHan	DongXin	3
ZhaoHuiTang	JamieMaclennan	1
YuhanCai	AlonY.Halevy	1
ZhiqiangZhang	JianhuaFeng	1
SusumuDate	ReijiTeramoto	1
JianPei	DaxinJiang	3
TakanobuNishiura	MitsunoriMizumachi	1
YiLin	RicardoJim*nez-Peris	1
ScottOster	KunHuang	1
Wing-KaiHon	SunilPrabhakar	1
StratisViglas	ByronChoi	1
YukimasaTamatsu	HiroakiKumon	1
KeiichiTamura	HajimeKitakami	1
ZheweiJiang	ChengLuo	1
RonaldoC.Prati	GustavoE.A.P.A.Batista	1
FarukPolat	AsumanDogac	1
TakeshiFukuda	HisashiKashima	1
ShonaliKrishnaswamy	ArkadyB.Zaslavsky	1
PhilipA.Bernstein	PaoloAtzeni	1
MichaelStonebraker	EdmondLau	1
BernhardStegmaier	AlfonsKemper	1
RoelVercammen	PhilippeMichiels	1
VictorM.Markowitz	KrishnaPalaniappan	1
PatriciaM.West	CarloCurino	1
KrithiRamamritham	AlanFekete	1
PhilippeThiran	Jean-LucHainaut	1
Shyh-KweiChen	MichailVlachos	1
PinarSenkul	AdnanYazici	1
TapioSalakoski	SampoPyysalo	1
Wing-HoShum	Kwong-SakLeung	1
YosukeSakao	SusumuAkamine	1
MichalisVazirgiannis	CarlottaDomeniconi	1
MassimoMecella	DanielaBerardi	1
WenliangDu	BiaoChen	1
ZhenjieZhang	NanWang	1
Jin-HaKim	GyuSangChoi	1
StanleyB.Zdonik	Jeong-HyonHwang	3
IhabF.Ilyas	ChengkaiLi	2
MitsunoriMizumachi	ChiyomiMiyajima	1
WenJin	JianPei	1
SriramPadmanabhan	BishwaranjanBhattacharjee	1
VanjaJosifovski	RobertLyle	1
DeanJacobs	AnnoLangen	1
ToddC.Mowry	ShiminChen	1
RajasekarKrishnamurthy	RaghavKaushik	1
OliverSeeliger	DenisChurin	1
OlfaNasraoui	BamshadMobasher	1
ZhimaoGuo	XiaolingWang	1
MauroBiajiz	AlanGavioli	1
RyoheiFujimaki	KazuoMachida	2
V*ctorRobles	JavierSegovia	1
NingKang	DanielBarbar*	1
Yi-PingPhoebeChen	JiyuanAn	1
IvanPopivanov	AlbertoLerner	1
TonyPan	RenatoFerreira	1
HuaxinZhang	DonghuiZhuo	1
TariqulHoque	QuamrulI.Khan	1
RuiZhou	GuorenWang	1
SrinivasanParthasarathy	SameepMehta	2
IstvanCseri	GideonSchaller	1
ShuqingWu	BettinaKemme	1
BhavaniRaskutti	AlanHerschtal	1
Ying-HanLiu	Ee-PengLim	1
Ming-SyanChen	Jan-MingHo	1
ViswanathanKrishnamurthy	RaviMurthy	1
WeiWang0009	HaixunWang	1
Chih-HsiangLin	ArbeeL.P.Chen	1
MasatoOguchi	MachikoToyoda	1
LouisLicamele	LiseGetoor	1
TakeharuEda	MakotoOnizuka	1
VictorVianu	DanielJ.Rosenkrantz	1
ZografoulaVagena	VassilisJ.Tsotras	1
GuyM.Lohman	ChunZhang	2
ShashiShekhar	MeteCelik	1
StanleyB.Zdonik	MagdalenaBalazinska	1
DeborahR.Carvalho	AlexAlvesFreitas	1
YiHuang	Hans-PeterKriegel	1
YoshinoriHara	AnastassiaAilamaki	1
Ming-ChienShan	FabioCasati	1
ShuigengZhou	LinhaoXu	1
KaushalSanghai	JenniferG.Dy	1
ShlomoArgamon	NavenduGarg	1
MichaelWilde	IanT.Foster	1
YuniXia	RahulShah	1
RiccardoRosati	GeorgGottlob	1
KennethSalem	HuaxinZhang	1
VincentOria	Genevi*veJomier	1
LinDong	EibeFrank	1
HoaNguyen	BedoorK.AlShebli	1
RedaAlhajj	ChunyanWang	1
MichaelJ.Carey	ArnonRosenthal	1
ReijiTeramoto	MasatoKitajima	1
PaulH.Leng	FransCoenen	2
ZacharyG.Ives	Kyu-YoungWhang	1
WolfgangLehner	SvenSchmidt	1
Fatma*zcan	DonaldD.Chamberlin	1
NihanKesimCicekli	FarukPolat	1
RobertLothian	IvanKoychev	1
ZhiqiangYang	RebeccaN.Wright	3
MartinD*umer	HaukeWalter	1
KrishnaKummamuru	DeepaParanjpe	1
Chun-ShengChen	ChristophF.Eick	1
TakuyaHiraoka	HirokoMano	1
KevinS.Beyer	Hui-IHsiao	1
RonaldFagin	RaviKumar	1
VikasArora	DanielaFlorescu	1
MartinD*umer	Carlo-FedericoPerno	1
SourashisRoy	JunghooCho	2
Tze-YunLeong	LiLin	1
SomakRaychaudhury	AtaKab*n	1
QingZhang	JeffreyXuYu	1
ShigekiMatsubara	KazuyaTakeda	1
LawrenceYou	KristalT.Pollack	1
KazuyaTakeda	AkiraSasou	1
StanleyB.Zdonik	ElizabethJ.O'Neil	1
PanosKalnis	AnthonyK.H.Tung	1
YukiMitsunaga	TakashiWashio	1
ThomasLengauer	HaukeWalter	1
TorstenGrabs	Hans-J*rgSchek	1
EnhuaJiao	CheeYongChan	1
ThomasA.Russ	MarcSpraragen	1
FarzinMaghoul	Chi-ChaoChang	1
JagannathanSrinivasan	EugeneInseokChong	1
OlgaPapaemmanouil	Jeong-HyonHwang	1
KlausHaller	HeikoSchuldt	1
JunYang	JingrenZhou	1
OliverSeeliger	IstvanCseri	1
StefanKramer	LinDong	1
SukhoLee	SangjunLee	1
WayneNiblack	JeongheeYi	1
MichaelJ.Carey	JeffPollock	1
PhilipS.Yu	BugraGedik	1
RaghuRamakrishnan	LeiChen0003	1
MinWang	LipyeowLim	1
YongShi	AidongZhang	1
NickKoudas	JayavelShanmugasundaram	1
Lo*ckLhote	ArnaudSoulet	1
TsuyokiNishikawa	MasaoSakata	1
JianjunHu	ChangjieTang	1
SrikanthBellamkonda	AndrewWitkowski	2
HamidPirahesh	Fatma*zcan	2
JohnRiedl	GeorgeKarypis	1
TomotakeNakamura	Shin'ichiWakabayashi	1
NicolasUsunier	AnastasiosTombros	1
HenkErnstBlok	DjoerdHiemstra	1
TadashiTsumura	HisashiKashima	1
VolkerHeun	StefanKramer	1
ClementT.Yu	BruceLambert	1
ShinYamamoto	MichimasaItoh	1
LawrenceYou	DarrellD.E.Long	1
ThomasEiter	GianluigiGreco	1
TianXia	DonghuiZhang	1
KeYi	JunYang0001	1
Zhi-HuaZhou	XiaoyangTan	1
RobertLyle	JimKleewein	1
Y*celSaygin	AliInan	1
PrateekJain	LaksV.S.Lakshmanan	1
RenatoFerreira	KunHuang	1
TapioSalakoski	EvgeniTsivtsivadze	1
XuelongLi	WeimingHu	1
MarkOette	GerdF*tkenheuer	1
ZhenHuaLiu	ViswanathanKrishnamurthy	1
NorbertoD*az-D*az	Jos*Crist*balRiquelmeSantos	1
MarkusSpannagel	FatihCoskun	1
YingYan	AoyingZhou	2
JiahengLu	ChangqingLi	1
VebjornLjosa	ArnabBhattacharya	1
Ghazi-NourdineBenadjaoud	GajananS.Chinchwadkar	1
YunboCao	JieTang	1
MichaelJ.Carey	JosephM.Hellerstein	1
YanifAhmad	Jeong-HyonHwang	1
XiaoyongLiu	MatthewB.Koll	1
VenkataNishanthLolla	NitinKumar	1
ManabuOhta	KaoruKatayama	1
Shou-JianYu	DimitriosGunopulos	1
SadokBenYahia	GhadaGasmi	1
RoelVercammen	JanParedaens	1
MaryE.Edgerton	DouglasH.Fisher	1
LingWang	LiefengBo	1
Min-SooKim0002	Kyu-YoungWhang	2
XiaochenWu	HaixunWang	1
YufeiTao	JianPei	1
NingLi	ChavdarBotev	1
StefanoCeri	AlessandroRaffio	1
SameepMehta	JohnWilkins	1
MingZhang	DongqingYang	1
TaeSikHan	JaewooKang	1
San-YihHwang	JaideepSrivastava	1
DapengLiu	ArtemChebotko	1
Jun'ichiTatemura	ArsanySawires	1
MattWelsh	JeffreyShneidman	1
VishalS.Batra	VijayshankarRaman	2
YasuhikoMorimoto	KazumitsuYagi	1
ShinichiUeshima	RyoNishide	1
ThaiQuangTung	DoheonLee	1
XiaorongLi	BaileShi	1
NickKoudas	AmitMarathe	1
ShaluGupta	FotoN.Afrati	1
YasushiOgawa	TakuyaHiraoka	1
SankarSubramanian	AmanNaimat	1
ZhengliHuang	WenliangDu	1
JunYan	DongZhuang	1
ZhengChen	LeefengChien	1
MarcSpraragen	GurmeetSingh	1
SankarSubramanian	LeiSheng	2
BillGallagher	AnnoLangen	1
MiguelFerreira	AdamBatkin	1
ElkeA.Rundensteiner	BinLiu	4
VishalSikka	AlonY.Halevy	1
WeiWang0009	JianPei	1
WolfgangNejdl	UweThaden	1
ManLungYiu	DimitrisPapadias	2
Jos*deJes*sP*rezAlc*zar	GilbertoZontaPastorelloJr.	1
PhilipS.Yu	JiaweiHan	3
AmersonLin	AlexRasin	1
SheilaA.Greibach	MosheY.Vardi	1
TianXia	EvangelosKanoulas	1
ShashiShekhar	JinSoungYoo	2
TakeshiYamada	ShingoKuroiwa	1
AstridL*greid	AmundTveit	1
VivekR.Narasayya	TheoVassilakis	1
PeterKunath	MatthiasRenz	2
NickKoudas	KenQ.Pu	1
TapioSalakoski	JormaBoberg	1
RobertAtlas	DavidEmmitt	1
ShiminChen	AnastassiaAilamaki	1
YongguangJiang	ChuanLi	1
ZografoulaVagena	MichailVlachos	2
WeiminXiao	ThomasM.Tirpak	2
SamuelMadden	AmolDeshpande	1
GarrickStaples	BrianMendenhall	1
MichaelPhilippsen	MarcW*rlein	1
NormenSeemann	ChunZhang	1
YasushiKiyoki	NobukoMiura	1
ViswanathanKrishnamurthy	VikasArora	1
P*velCalado	BaopingZhang	2
MauricioA.Hern*ndez	LauraM.Haas	1
KazuyaTakeda	HiroshiFujimura	1
ClaudioGiuliano	AlfioMassimilianoGliozzo	1
ThorstenMeinl	MarcW*rlein	1
VladislavShkapenyuk	S.Muthukrishnan	1
SiegfriedNijssen	BartGoethals	1
TingSu	KaushalSanghai	1
JustinZobel	DonaldMetzler	1
SamuelMadden	AdamBatkin	1
SusanPaulsen	AndrewB.Nobel	1
YanzanZhou	BamshadMobasher	1
JeffreyD.Ullman	DanielJ.Rosenkrantz	1
WolfgangFaber	GeorgGottlob	1
WenyinLiu	BenyuZhang	1
SoumenChakrabarti	HrishikeshKarambelkar	1
MouradOuzzani	AhmedK.Elmagarmid	1
SriharshaVeeramachaneni	PaoloAvesani	1
NingLiu	LeefengChien	1
Wei-YingMa	ChuangWang	1
TingSu	JenniferG.Dy	1
PhilipS.Yu	MyraSpiliopoulou	1
XuehuaShen	ChengXiangZhai	1
TuBaoHo	SusumuHoriguchi	1
RyanRich	DanielR.Jeske	1
YiLin	BettinaKemme	1
TobiasSing	ThomasLengauer	1
ZhenZhang	KevinChen-ChuanChang	3
OlivierBuisson	CarlFr*licot	1
MichelangeloCeci	DonatoMalerba	1
MichaelJ.Carey	DeniseDraper	1
ThomasLengauer	Carlo-FedericoPerno	1
P.SreenivasaKumar	K.HimaPrasad	1
QiangLi	BoZhang	1
GiovambattistaIanni	GiorgioTerracina	1
FangBian	ChristopheDiot	1
QinLu	HongVaLeong	1
LindaSmail	Jean-PierreRaoult	1
KentaroWakatsuki	GenKawamura	1
ZhengShao	JiaweiHan	1
ShipraAgrawal	JayantR.Haritsa	1
RajkumarSen	KrithiRamamritham	1
ElhamFazli	ArielFuxman	1
HaukeWalter	DanielHoffmann	1
JoydeepGhosh	ArindamBanerjee	1
XuedongChen	DanielJ.Abadi	1
NormenSeemann	GuyM.Lohman	1
StanleyB.Zdonik	MarkHumphrey	1
ToshikiEndo	NorihideKitaoka	1
PrasenjitMitra	DongwonLee	1
FuzongLin	BoZhang	1
PhilippeMulhem	JeanMartinet	1
RajeevRastogi	HongjunLu	1
RajaTanveerIqbal	JingPeng	1
LeiChen0003	Bee-ChungChen	1
HanliWang	Chi-HoTsang	1
XiaofengMeng	DongdongHu	1
SureshVenkatasubramanian	HarshaV.Madhyastha	1
SubbaraoKambhampati	JianchunFan	1
HongboXu	BinWang	1
YolandaGil	BrianMendenhall	1
YunboCao	DmitriyMeyerzon	1
KeYi	HaoHe	1
PhilipS.Yu	JianPei	3
XiaofengMeng	HaixunWang	1
LanYe	DouglasHolt	1
MaudeManouvrier	MartaRukoz	1
Fatma*zcan	BertVanderLinden	2
WolfgangFaber	GiovambattistaIanni	1
WonikChoi	SangjunLee	1
PanagiotisPapapetrou	GeorgeKollios	1
MitchCherniack	AmersonLin	1
NaveenAshish	ArnonRosenthal	1
WouterAlink	MauricevanKeulen	1
SteveBridges	SteffenBickel	1
MatthiasBrantner	GuidoMoerkotte	2
ThomasSeidl	JostEnderle	1
MitchCherniack	MichaelStonebraker	1
ManueldelValle	FernandoJ.Corbacho	1
YixinChen	HenryL.BartJr.	1
PaulGreenfield	AlanFekete	1
NingZhang0002	DonghuiZhuo	1
YasuyukiShirai	NoriyoshiYamauchi	1
RobertGwadera	MikhailJ.Atallah	1
TorstenGrabs	CanT*rker	1
PeerKr*ger	MatthiasSchubert	1
JessicaLin	DimitriosGunopulos	1
NaveenAshish	JeffPollock	1
TakashiTomii	HiroyasuMinami	1
KevinS.Beyer	HamidPirahesh	2
YingZhang	TaoJia	1
JoshuaZhexueHuang	JihongGuan	1
EllisHorowitz	DanielJ.Rosenkrantz	1
ThodorisTsotsos	GeorgiaKoloniari	1
YunSingKoh	NathanRountree	1
PanayiotisTsaparas	FotoN.Afrati	1
YuXu	Fatma*zcan	1
Mar*aA.Nieto-Santisteban	DavidT.Liu	1
VincentOria	MaudeManouvrier	1
TakuyaHiraoka	HiroshiTakegawa	1
RichardT.Snodgrass	HolgerMeyer	2
SandeepMane	JaideepSrivastava	2
JihieKim	BrianMendenhall	1
YongjinKang	YongJinKwon	1
NguyenSinhHoa	HungSonNguyen	1
XiangLi	DavidEmmitt	1
SeanCox	PengyueJ.Lin	1
TobiasSing	HaukeWalter	1
PhokionG.Kolaitis	D.Sivakumar	1
W.BretChurch	LiorLukov	1
YongluanZhou	Kian-LeeTan	2
XiangLi	Juan-CarlosJusem	1
LiubaShrira	HaoXu	1
Tak-ChungFu	Pui-yingTang	1
TruH.Cao	TranA.Dung	1
MarkOette	FrancescaCeccherini-Silberstein	1
Fran*oisDangNgoc	CosminCremarenco	1
YihengLi	EdoardoAiroldi	1
VincentShin-MuTseng	Ja-HwungSu	1
JaideepVaidya	ChrisClifton	2
TakeshiFukuda	TadashiTsumura	1
KazuoHiyane	FumihiroKumeno	1
MonicaMarcus	AlinDeutsch	1
Shyh-KweiChen	PhilipS.Yu	1
TolgaBozkaya	ShrikanthShankar	1
Fr*d*ricFlouvat	FabienDeMarchi	1
TobiasSing	NikoBeerenwinkel	1
NingLi	EugeneJ.Shekita	1
Tian-yangLv	ShaobinHuang	1
KennyDaniel	DanielB.Neill	1
HamidPirahesh	GeorgeLapis	1
JingSun	HangGuo	1
ReijiTeramoto	HideoMatsuda	1
RicardoCartaxoModestodeSouza	MarcelinoPereiradosSantosSilva	1
ZhengluYang	MasaruKitsuregawa	1
UtkarshSrivastava	PeterJ.Haas	1
ZhihongChong	HongjunLu	1
K.Sel*ukCandan	InderpalNarang	1
Tat-SangChoy	SrinivasanParthasarathy	1
ToshikiEndo	KazuyaTakeda	1
LinusLiang	AnilEdakkunni	1
YolandaGil	ThomasA.Russ	1
RobertStockton	KamalNigam	1
YasuhiroSuzuki	ToshiakiFujii	1
YuDeng	EdwardHung	1
KoenVanhoof	GerritK.Janssens	1
XuedongChen	StanleyB.Zdonik	1
YvesChiaramella	JeanMartinet	1
XueLi	JorgeM.Barajas	1
S.Sudarshan	H.S.Ramanujam	1
YildirayKabak	AsumanDogac	1
WeiPeng	TaoLi	2
PilarHerrero	Mar*aS.P*rez	1
MinghuaZhang	BenKao	1
YujiMatsumoto	TakahikoIto	1
Min-WooLee	Ji-HoonKang	1
YolandaGil	KaranVahi	1
KeWang	JianLiu	1
XiaopengXiong	MohamedF.Mokbel	1
LewisFrey	DouglasH.Fisher	1
RaviRajwar	J.EliotB.Moss	1
PengyueJ.Lin	BehrokhSamadi	1
JiahengLu	CheeYongChan	1
XiaoyangTan	FuyanZhang	1
XifengYan	ChenWang	1
IvanPopivanov	DanielC.Zilio	1
JianyongWang	HaixunWang	1
MelanieWeis	FelixNaumann	2
WenjuanXing	BradleyBerg	1
StevenMinton	MatthewMichelson	1
WeiFan	EdGreengrass	1
VincentOria	Bj*rn**rJ*nsson	1
OliverSeeliger	GideonSchaller	1
LucBouganim	Fran*oisDangNgoc	1
SotirisBrakatsoulas	RandallSalas	1
MaurizioLenzerini	GianluigiGreco	1
HenriBriand	FabriceGuillet	1
ShuigengZhou	AoyingZhou	1
Ming-SyanChen	Hung-LengChen	1
JianliangXu	HaiboHu	2
SanasamRanbirSingh	AnjanaK.Mahanta	1
MoonjungCho	JianPei	1
S.Muthukrishnan	IrinaRozenbaum	2
MohammedJaveedZaki	MarkusPeters	2
TsuyokiNishikawa	HiroshiSaruwatari	1
SurajitChaudhuri	LuborKoll*r	1
KatsuyukiSawai	DaisukeSaitoh	1
JianPei	HaixunWang	4
TimothyM.Sutherland	MarianaJbantova	1
YvesChiaramella	PhilippeMulhem	1
RalfSchenkel	GerhardWeikum	3
ZhaoLi	WeeKeongNg	1
CaroleA.Goble	BertramLud*scher	1
Kwok-YanLam	Jian-TaoSun	1
VasilisMegalooikonomou	LonginJanLatecki	1
MatthiasGro*mann	DanielaNicklas	2
SutanuChakraborti	IvanKoychev	1
RamakrishnanSrikant	DilysThomas	1
DanielaFlorescu	Anh-TuanTran	1
RobertMcCann	LongVu	1
ToshihiroUehara	HaruoYokota	2
MatthiasRenz	MartinPfeifle	2
LingChen0002	Liang-TienChia	1
NigelEllis	ConorCunningham	1
RiccardoRosati	LucaGrieco	1
TakehiroFurudate	TakahiroKosaka	1
LukasBlunschi	DonaldKossmann	1
LiWei	EamonnJ.Keogh	1
RuiZhou	ChuanYang	1
ShashankPandit	RushiDesai	1
HaruoYokota	DaiKobayashi	3
MartaPati*o-Mart*nez	BettinaKemme	1
Shin'ichiKobayashi	FumihiroKumeno	1
PaoloTrunfio	DomenicoTalia	1
TakashiTomii	KazunoriSunako	1
YiLiu	RongJin	1
Yan-NeiLaw	CarloZaniolo	1
KaveEshghi	GeorgeForman	1
XiaochenWu	BaileShi	1
ShinjiShimojo	HideoMatsuda	1
TimW.Nattkemper	ClaudioVarini	1
NormenSeemann	Fatma*zcan	1
LinGuo	KevinS.Beyer	1
SurajitChaudhuri	KrisGanjam	1
JinboBi	GlennFung	2
IngolfGeist	EikeSchallehn	1
YuujiHotta	LilianHarada	1
SteffenBickel	RolfSchimpfky	1
NikosMamoulis	DimitrisPapadias	2
TakahiroKosaka	KazutoYamazaki	1
SudhirVerma	AmitJ.Shah	1
RobertMcCann	OluSobulo	1
YuqingWu	SriramMohan	1
ThomasLegler	SvenSchmidt	1
JuanRobles	JacintoGonz*lez-Pach*n	1
PeterBert*k	KwongYuenLai	1
GerdHeber	DavidJ.DeWitt	1
JianyongWang	JianPei	1
YanchangZhao	ChengqiZhang	1
RudolfKruse	FrankKlawonn	1
MarcPlantevit	DominiqueLaurent	1
GiacomoGamberoni	FabrizioRiguzzi	1
ZhiyongPeng	BoxuanZhai	1
ZsoltTivadarKardkov*cs	Zolt*nB*ns*ghi	1
StefanoVolinia	FabrizioRiguzzi	1
Ren*eJ.Miller	ElhamFazli	1
QiongLuo	DanHong	1
BradleyBerg	AnjaliJhingran	1
ShankarPal	IstvanCseri	1
LeiJiang	AnastasiosKementsietsidis	1
HaixunWang	CarloZaniolo	1
PhilipA.Bernstein	ErhardRahm	1
VladislavShkapenyuk	KedarDhamdhere	1
MichaelStonebraker	HariBalakrishnan	1
MichaelRys	DonaldD.Chamberlin	1
FrancescaDemichelis	EmanueleOlivetti	1
HuanmeiWu	GregoryC.Sharp	1
DongZhuang	BenyuZhang	1
QiGuo	JianhuaFeng	1
ToddC.Mowry	J.GregorySteffan	1
VadirajaBhatt	BharatRane	1
WindsorW.Hsu	QingboZhu	1
SampoPyysalo	AleksandrMyll*ri	1
V*ctorRobles	PilarHerrero	1
PaoloCeravolo	ErnestoDamiani	1
PatriciaRodr*guez-Gianolli	LeiJiang	1
WenfeiFan	RobertHutchison	1
StanSclaroff	DimitriosGunopulos	1
DunluPeng	AoyingZhou	1
ThomasFahringer	RaduProdan	1
LianhongTang	LewisFrey	1
RossSparks	HuidongJin	1
TedYounglove	PengyueJ.Lin	1
JulienPrados	AlexandrosKalousis	2
OksanaYakhnenko	AdrianSilvescu	1
JulianaFreire	DenilsonBarbosa	1
SridharGullapalli	HansChalupsky	1
Jos*Iborra	ArturBoronat	1
JayavelShanmugasundaram	AntalNovak	1
MarioA.Nascimento	JamesElding	1
QiangYe	AvigdorGal	1
TakehiroFurudate	MasatoKitajima	1
PrasannaGanesan	HectorGarcia-Molina	1
SusanKotsovolos	Anh-TuanTran	1
ToreRisch	Jean-LucHainaut	1
ZhiqiangZhang	JingSun	1
Jos*A.Cars*	ArturBoronat	1
RuomingJin	DmitriiPolshakov	1
RuiXiao	PengyueJ.Lin	1
MaiSoramoto	KazumitsuYagi	1
IvanBratko	GregorLeban	1
SusanKotsovolos	SivasankaranChandrasekar	1
Jos*Ranilla	El*asF.Combarro	1
JiuyongLi	ChrisKelman	1
VincenzinoLio	GiorgioTerracina	1
DoheonLee	Dae-WonKim	1
RaviKumar	DavidGibson	1
ClementT.Yu	AnHaiDoan	1
JayavelShanmugasundaram	DiveshSrivastava	1
ZhenHuaLiu	JamesW.Warner	1
MichaelFink	BartoszNowicki	1
QingzhaoTan	PengLiu	1
MehmetKeskin*z	Ay*aAzginHintoglu	1
RobinD.Burke	ChadWilliams	2
YingXing	AnjaliJhingran	1
JaideepSrivastava	CarsonMurray	1
Sang-ChanPark	JiYoungWoo	1
PeterJ.Haas	AlbertoLerner	1
SusumuHoriguchi	MinhLeNguyen	1
NormenSeemann	JimKleewein	1
LeiSheng	AllisonWaingold	1
MohamedH.Ali	AbdelsalamHelal	1
MichalisVazirgiannis	DimitriosMavroeidis	1
XiaoyangSeanWang	LikeGao	1
JingrenZhou	DimitriosGunopulos	1
ParkeGodfrey	LeopoldoE.Bertossi	1
SusumuAkamine	SatoshiMorinaga	1
HaiquanLi	DonnySoh	1
SimonCorston-Oliver	MichaelGamon	1
YuhanCai	JingMichelleLiu	1
LeiShi	GeYu	1
ThomasRisse	PredragKnezevic	1
MarkHumphrey	Jeong-HyonHwang	1
KarstenDraba	AlexanderBilke	1
BarryR.Cobb	AntonioSalmer*n	1
RaymondJ.Mooney	ChaseKrumpelman	1
NingShang	Fang-zhongSu	1
PatrickGallinari	Huyen-TrangVu	1
Tak-ChungFu	Chak-manNg	1
WingSingWong	HaiboHu	1
UpendraSharma	KoustuvDasgupta	1
Ning-HanLiu	ArbeeL.P.Chen	1
NingLi	Hui-IHsiao	1
PhuChienNguyen	KouzouOhara	1
VolkerMarkl	MarcelKutsch	1
RalfHartmutG*ting	FrankHoffmann	1
IoanaManolescu	AndreiArion	1
DomenicoSacc*	AntonellaGuzzo	1
WeipingGe	BaileShi	1
IvanBratko	BlazZupan	2
GianluigiGreco	GeorgGottlob	1
VictorTeixeiradeAlmeida	ThomasH*se	1
MichalisVazirgiannis	GeorgeTsatsaronis	1
Wang-ChienLee	PengLiu	1
WeiguoFan	MarcoCristo	1
ChristianKleinerman	C*sarA.Galindo-Legaria	1
ShrikanthShankar	SankarSubramanian	1
Hyung-JeongYang	ChristosFaloutsos	1
Young-HoPark	Wook-ShinHan	1
PeixiangZhao	DongqingYang	1
VolkerMarkl	MokhtarKandil	1
PhilipS.Yu	BoLong	2
JieChen	HongxingHe	1
MasakiyoFujimoto	AkiraSasou	1
ThomasKabisch	CarmenCostilla	1
JohnShepherd	JialieShen	1
SusanKotsovolos	NipunAgarwal	1
QingLi	JianZhai	1
TakeshiFukuda	HiroakiEtoh	1
Jia-JinLe	EamonnJ.Keogh	1
SaileshKrishnamurthy	LinusLiang	1
WalidG.Aref	AhmedK.Elmagarmid	3
PengyueJ.Lin	LanYe	1
StefanieRinderle	ManfredReichert	1
MikaelRonstr*m	JonasOreland	1
TobiasSing	J*rgenK.Rockstroh	1
RicardoJim*nez-Peris	MartaPati*o-Mart*nez	1
YuXu	DonaldD.Chamberlin	1
StephenBalakirsky	ElenaMessina	1
S.AlirezaAghili	AmrElAbbadi	1
OliverM.Donzelli	GuidoMiraglia	1
MarcSpraragen	CarlKesselman	1
GregoryBuehrer	AnthonyD.Nguyen	1
LeslieCranston	BishwaranjanBhattacharjee	1
KenichiKaku	HiroyasuMinami	1
RaghavKaushik	JeffreyF.Naughton	1
SunitaSarawagi	ShantanuGodbole	1
ParaskevasV.Lekeas	FotoN.Afrati	1
OlfaNasraoui	CesarCardona	1
P*velCalado	EdwardA.Fox	2
DavidEmmitt	BilahariAkkiraju	1
TaoJia	JianChu	1
LeiJiang	JohnMylopoulos	1
ShobhitMathur	NileshN.Dalvi	1
ShiyongLu	ArtemChebotko	1
TanuMalik	RandalC.Burns	1
JureLeskovec	ChristosFaloutsos	2
SihemAmer-Yahia	PrateekJain	1
StanleyB.Zdonik	EdmondLau	1
SrikanthBellamkonda	AmanNaimat	1
IreneD*az	ElenaMonta**s	1
QixiangSun	HectorGarcia-Molina	1
DanielB.Neill	AndrewW.Moore	1
Kian-LeeTan	ArpitJain	1
MarcoCristo	BaopingZhang	1
YongXiaojia	JianjunHu	1
Ming-ChienShan	Mal*Castellanos	1
JuhoMuhonen	HannuToivonen	1
RolfSchimpfky	PeterSiemen	1
SeonHoKim	AliE.Dashti	1
VasantHonavar	AdrianSilvescu	1
ZhipengXie	Mong-LiLee	1
ZhenHuaLiu	EricSedlar	1
Jia-YuPan	Hyung-JeongYang	1
KurtStockinger	KeshengWu	1
Tie-YanLiu	QianShengCheng	1
Tak-ChungFu	RobertWingPongLuk	1
MosheFresko	BinyaminRosenfeld	2
Kyu-YoungWhang	HolgerMeyer	2
ToshihiroUehara	RyoTaguchi	2
AmanNaimat	AllisonWaingold	1
PhilShaw	GajananS.Chinchwadkar	1
KatsuyukiSawai	AkinobuLee	1
NingKang	CarlottaDomeniconi	1
SrinivasanParthasarathy	RaghuMachiraju	1
RobertLyle	NormenSeemann	1
Shin'ichiKobayashi	HiroshiInujima	1
LinGuo	JayavelShanmugasundaram	1
DeniseDraper	AlonY.Halevy	1
ThomasA.Russ	JihieKim	1
HananSamet	EgemenTanin	1
SergioStorari	FabrizioRiguzzi	1
RichardNock	PascalPoncelet	1
JussiMyllymaki	HamidPirahesh	1
DraganTomic	BrandonBerg	1
MauricioA.Hern*ndez	MaryRoth	1
OresteVerta	DomenicoTalia	1
Zhi-HongDeng	MingZhang	1
WeiHong	CarlosGuestrin	1
MarkOette	KlausKorn	1
YasushiSakurai	ChristosFaloutsos	2
VikasArora	EricSedlar	1
YuniXia	ShanLei	1
SaikatMukherjee	I.V.Ramakrishnan	1
ShuangLiu	OphirFrieder	1
KazuyaTakeda	KatunobuItou	1
SteveB.Jiang	HirokiShirato	1
VebjornLjosa	AmbujK.Singh	1
SridharGullapalli	MaureenDougherty	1
EricK.Y.Ho	ArnoJ.Knobbe	1
VivekR.Narasayya	KrisGanjam	1
WitoldStaniszkis	NicolaLeone	1
MokhtarKandil	AlbertoLerner	1
ShreeRaman	PrasanRoy	1
BrianVickery	BertVanderLinden	1
YingYan	XueqingGong	1
TakahiroKosaka	HideoMatsuda	1
PaoloTrunfio	OresteVerta	1
YaliZhu	ElkeA.Rundensteiner	1
BradleyBerg	AlexRasin	1
MartinMichalowski	ClaudeNanjo	1
YingFeng	DivyakantAgrawal	2
RobertStockton	NatalieS.Glance	1
YangboZhu	ShaozhiYe	1
Y*celSaygin	MehmetKeskin*z	1
JianshuWeng	ChunyanMiao	1
GeYu	ChenLi	1
PhilShaw	Ghazi-NourdineBenadjaoud	1
StefanManegold	JensTeubner	1
HiroshiMotoda	AlexandreTermier	1
SampoPyysalo	EvgeniTsivtsivadze	1
RohitJain	AkshatVerma	1
SergeAbiteboul	JeffreyD.Ullman	1
YutakaYanagisawa	TetsujiSatoh	1
JihieKim	GurmeetSingh	1
SeanCox	MinhLy	1
RaviRajwar	CliffB.Jones	1
MaartendeRijke	B*rkurSigurbj*rnsson	1
SvenSchmidt	SebastianSch*r	1
RobertWingPongLuk	Pui-yingTang	1
LarsSchmidt-Thieme	FerencBodon	1
RobertaCochrane	KevinS.Beyer	1
SaileshKrishnamurthy	MichaelJ.Franklin	1
KiyohiroShikano	AkinobuLee	1
MinhLy	DouglasHolt	1
XinLunaDong	JayantMadhavan	1
TakashiOgawa	HiroakiKumon	1
VasileiosMegalooikonomou	RolfLak*mper	1
MasayukiKuroda	K.M.AzharulHasan	1
DennisGannon	BethPlale	1
ToshikiEndo	TakanobuNishiura	1
WenyinTang	KezhiMao	1
YingYang	XindongWu	1
Jos*deJes*sP*rezAlc*zar	ClaudiaBauzerMedeiros	1
ScottLogan	JerryKiernan	1
VincentOria	M.Tamer*zsu	1
RuiWang0002	ChendongZou	1
Kai-UweSattler	EikeSchallehn	1
PhilippeMichiels	JanParedaens	1
MaheshkumarSabhnani	AndrewW.Moore	1
SerapDurmaz	DanOlteanu	1
LionelSavary	KarineZeitouni	1
NathanBurkhart	LinusLiang	1
MihirShah	KennethA.Ross	1
MinSong	IllhoiYoo	1
MineichiKudo	HidehikoIno	1
TobiasSing	GerdF*tkenheuer	1
TsuyokiNishikawa	KiyohiroShikano	1
MichaelK.Ng	JunXu	1
Rog*riodeLemos	HenryF.Korth	1
MarkSchmidt	Chi-HoonLee	1
StefanoCeri	MarcoBrambilla	1
Shinn-YingHo	Fu-ChiehYu	1
ZhongmingHan	JiajinLe	1
YasuhiroSuzuki	MasatoKoyamaishi	1
OphirFrieder	EricC.Jensen	1
YannisTheodoridis	PanosVassiliadis	1
NicolasUsunier	MouniaLalmas	1
JanezDemsar	BlazZupan	1
Ming-TingSun	BelleL.Tseng	1
ValentinaSvicher	Carlo-FedericoPerno	1
WolfgangFaber	MaurizioLenzerini	1
MartinD*umer	DanielHoffmann	1
OlivierBuisson	AlexisJoly	1
LatifurKhan	FlorentMasseglia	1
MasatoOguchi	KikukoKamisaka	1
SrikanthBellamkonda	SankarSubramanian	2
RichardKuntschke	AngelikaReiser	1
KazuyaTakeda	ChiyomiMiyajima	1
RajeevRastogi	MichaelFlaster	1
V*clavSn*sel	JaroslavPokorn*	1
TimFurche	FatihCoskun	1
MohamedF.Mokbel	AhmedK.Elmagarmid	1
YutakaKidawara	YuheiAkahoshi	1
YuweiPeng	WeipingXie	1
PeterJ.Haas	MokhtarKandil	1
RadaChirkova	RachelPottinger	1
KennethA.Ross	DimitriosGunopulos	1
SpiridonBakiras	Kian-LeeTan	1
XinLi	FangBian	1
ChrisKelman	AdaWai-CheeFu	1
ToshihideSutou	MakotoTakaki	1
KrzysztofKoperski	JishengLiang	1
TianyiWu	BaileShi	1
NicolaLeone	EdytaKalka	1
YasushiKiyoki	ShuichiKurabayashi	1
Shu-ChingChen	Mei-LingShyu	1
MihirShah	JohnCieslewicz	1
PeterTriantafillou	ChristianZimmer	1
RichardNock	Pierre-AlainLaur	1
RuiZhang0003	NickKoudas	1
RicardodaSilvaTorres	Jos*deJes*sP*rezAlc*zar	1
AhmedK.Elmagarmid	AbdelsalamHelal	1
DavidJ.DeWitt	ChristianS.Jensen	1
YiLin	LeiChen0003	1
WolfgangFaber	BartoszNowicki	1
KenichiKaku	HiroyukiNasu	1
YunhuaHu	YunboCao	1
YongYu	KeweiTu	1
TuongC.Truong	GuyM.Lohman	1
WalidG.Aref	ElisaBertino	1
KevinChen-ChuanChang	IhabF.Ilyas	2
RussellGreiner	MarkSchmidt	1
MiltiadisSarakinos	MartinAlbrecht	1
YosukeSakao	SatoshiMorinaga	1
Lu*sRodrigues	J.EliotB.Moss	1
KatharinaGr*n	J*rgenDorn	1
YasushiOgawa	HideoItoh	1
YutakaKatsuyama	WataruNakano	1
ThomasKamps	PeterFankhauser	1
Min-WooLee	Min-OkJung	1
ZhihaoZhang	DeyiLi	1
Yi-PingPhoebeChen	QinyingXu	1
TingChen	JiahengLu	2
Yi-HungWu	Ning-HanLiu	1
Wang-ChienLee	QingzhaoTan	1
RyoHirade	HiroakiEtoh	1
Ugur*etintemel	MarkHumphrey	1
PeterTriantafillou	GerhardWeikum	2
PauloBrazGolgher	BrunoM.Fonseca	1
ShankarPal	AdrianBaras	1
NickKoudas	ChenLi	1
QinLu	JingZhou	1
JensGraupmann	GerhardWeikum	1
DanSuciu	ChristopherR*	1
SamyBengio	DavidGrangier	1
OguzhanTopsakal	MichaelStonebraker	1
W.BruceCroft	JustinZobel	1
MarkusSpannagel	Fran*oisBry	1
EsperanzaMarcos	ArantzaIllarramendi	1
UlrichKreher	StefanieRinderle	1
KangZhang	D.T.Huynh	1
JimKleewein	BrianVickery	1
NaiyaoZhang	MuyuanWang	1
DavidG.Bell	DavidA.Maluf	1
JunYang	DimitriosGunopulos	1
ShannonHastings	ScottOster	1
SrikanthBellamkonda	NathanFolkert	1
TerranLane	PhilipChan	1
TakanobuNishiura	NorihideKitaoka	1
VladimirZadorozhny	QiangYe	1
ThomasEiter	BartoszNowicki	1
YasuhikoMorimoto	MaiSoramoto	1
WeiWang0010	AnthonyK.H.Tung	1
YingyuanXiao	GuoQiongLiao	1
MonicaMarcus	DayouZhou	1
PhilipA.Bernstein	M.Tamer*zsu	2
LuisF.Lago-Fern*ndez	BeatrizS*nchez	1
MaryRoth	HowardHo	1
NivioZiviani	BrunoM.Fonseca	1
LucianPopa	HowardHo	1
TadahikoKumamoto	KatsumiTanaka	1
TingChen	CheeYongChan	1
SusanneE.Hambrusch	AnnChristineCatlin	1
SudhirVerma	MoninderSingh	1
ZhiyuanChen	JohannesGehrke	1
MarcSpraragen	BrianMendenhall	1
FotoN.Afrati	CharlesLoftis	1
RobCardwell	AlexMiller	1
SunilPrabhakar	AlanKwan	1
MarcusFontoura	ChavdarBotev	1
SrinivasanParthasarathy	MohammedJaveedZaki	1
WeiguoFan	MarcosAndr*Gon*alves	2
NatalieS.Glance	MatthewHurst	1
JeffreyD.Ullman	EllisHorowitz	1
FedericaMandreoli	EnricoRonchetti	1
RuiZhang0003	DiveshSrivastava	1
ZhengLiu	XueminLin	1
TimothyChorma	JagannathanSrinivasan	1
YukimasaTamatsu	TakashiOgawa	1
PrasanRoy	MukeshK.Mohania	2
ViktorGyenes	B*lintG*bor	1
PeterA.Boncz	JanRittinger	1
PeerKr*ger	ChristianB*hm	1
YanivBernstein	W.BruceCroft	1
SamuelMadden	MiguelFerreira	1
HuanHuo	ChuanYang	1
RunaBhaumik	RobinD.Burke	2
WilfredNg	HoLamLau	2
YingChen	ToddEavis	1
SabrinaDeCapitanidiVimercati	ErnestoDamiani	1
MohamedA.Soliman	IhabF.Ilyas	1
YuanyuanJia	CarloCurino	1
LingzhiZhang	JulianaFreire	1
PrabhakarRaghavan	AnirbanDasgupta	1
QiangYang	JeffreyJunfengPan	1
SaraJ.Graves	BilahariAkkiraju	1
ManueldelValle	BeatrizS*nchez	1
RaviRajwar	HenryF.Korth	1
J*rgenK.Rockstroh	FrancescaCeccherini-Silberstein	1
SteveBarr	SrinivasanParthasarathy	1
Wook-ShinHan	Min-JaeLee	1
NitinKumar	CarlottaDomeniconi	1
MarkusSpannagel	DanOlteanu	1
SugataGhosal	KoustuvDasgupta	1
QiangWang	Chotirat(Ann)Ratanamahatana	2
ShichaoZhang	ChengqiZhang	1
XiaomingJin	DeyiLi	1
PedroCoutinho	FranciscoM.Couto	1
RaviSundaram	RamanathanV.Guha	1
StefanoVolinia	SergioStorari	1
TianyiWu	ChenWang	1
VincentSchickel-Zuber	BoiFaltings	1
MichaelR.Berthold	A.SimonaPintilie	1
VassilisJ.Tsotras	MirellaMouraMoro	1
SankarSubramanian	AbhinavGupta	1
T.S.Jayram	PrasadDeshpande	1
XueqiCheng	HongboXu	1
YunshengLiu	YingyuanXiao	1
ElisaBertino	BarbaraCarminati	2
RongJin	MichaelR.Lyu	1
Jean-LucHainaut	JeanHenrard	1
IrinaRish	EmreErdogan	1
ShenjieLi	HangLi	1
WitoldStaniszkis	EdytaKalka	1
TakashiWashio	KouzouOhara	2
YuriBreitbart	Hans-J*rgSchek	1
PrasannaKumarDesikan	ColinDeLong	1
MichaelA.Harrison	JeffreyD.Ullman	1
LonginJanLatecki	EamonnJ.Keogh	2
XiaorongLi	WeiWang0009	1
RandallHauch	AlexMiller	1
ZhihuaChen	LewisFrey	1
DavidT.McWherter	BiancaSchroeder	1
PhilShaw	FrancisPang	1
Wing-KaiHon	WalidG.Aref	1
YingLiu	Wei-kengLiao	1
RajeshBordawekar	ChristianA.Lang	1
M*rioJ.Silva	FranciscoM.Couto	1
BengChinOoi	AnthonyK.H.Tung	1
ElisaBertino	AndreasHeuer	1
RiccardoRosati	GiorgioTerracina	1
HuanHuo	GuorenWang	1
OsmarR.Za*ane	OlfaNasraoui	1
Kuo-YuHuang	Chia-HuiChang	1
JanPrins	AndrewB.Nobel	1
RobertH.Deng	BengChinOoi	1
LianhongTang	DouglasH.Fisher	1
GregoryBuehrer	DaehyunKim	1
ShetalShah	KrithiRamamritham	1
HarshaV.Madhyastha	BalachanderKrishnamurthy	1
NguyenCamChi	HoangNgocMinh	1
JunXu	HangLi	1
SerapDurmaz	MarkusSpannagel	1
YosukeSakao	HirokiArimura	1
WeipingGe	WeiWang0009	1
TakashiOkada	HirotakaNiitsuma	1
NoriyoshiYamauchi	HiroshiInujima	1
YujiMatsumoto	TakuKudo	1
YufeiTao	MartinEster	1
QiangYang	Jian-TaoSun	1
TakeshiYamada	MitsunoriMizumachi	1
MilenkoPetrovic	HaifengLiu	1
TomotakeNakamura	NoriyoshiYoshida	1
W.BruceCroft	DonaldMetzler	1
DonaldMetzler	AlistairMoffat	1
XiaomingJin	JianminWang	1
RaviKumar	JasmineNovak	2
TobiasSing	DanielHoffmann	1
ScottOster	*mitV.*ataly*rek	1
PhilipS.Yu	BrijM.Masand	1
HaruoYokota	AkitsuguWatanabe	4
Rog*rioLu*sdeCarvalhoCosta	MairaFerreiradeNoronha	1
JianLiu	HaixunWang	1
UmeshwarDayal	Ming-ChienShan	1
WeiYu	DraganTomic	1
ViswanathanKrishnamurthy	SusanKotsovolos	1
HuiZhang	FrederickH.Lochovsky	1
WenshengWu	AnHaiDoan	1
TobiasScheffer	DavidS.Vogel	1
TakahideNogayama	HisashiKashima	1
XiaoxinYin	PhilipS.Yu	1
XiangLi	RobertAtlas	1
KrithiRamamritham	ChinyaV.Ravishankar	1
ToruFujiwara	KenjiHashimoto	1
RobertHutchison	PeterBuneman	1
GilbertoZontaPastorelloJr.	ClaudiaBauzerMedeiros	1
PinarSenkul	NihanKesimCicekli	1
KennethA.Ross	JuliaStoyanovich	1
SrinivasanParthasarathy	PradeepDubey	1
ShigeruShimada	KishikoMaruyama	1
NaveenAshish	DavidA.Maluf	1
MohammedJaveedZaki	IraAssent	1
RobertLyle	HamidPirahesh	1
MichailVlachos	Kun-LungWu	1
LingLiu	Kun-LungWu	1
RasmusKaae	AlbrechtSchmidt0002	1
MarcoRuzzi	GiovambattistaIanni	1
JonghoonChun	JinwookChoi	1
DongtaoLi	AngelaGoh	1
HetalThakkar	HaixunWang	1
ToyohideWatanabe	NaotoMukai	1
EdoardoAiroldi	BradleyMalin	1
XingLi	ShaozhiYe	1
MaureenDougherty	CarlKesselman	1
VishalSikka	SangKyunCha	1
VanjaJosifovski	GuyM.Lohman	2
AlessandroRaffio	AlessandroCampi	1
WitoldStaniszkis	DomenicoLembo	1
ZhengliHuang	BiaoChen	1
PengyueJ.Lin	MinhLy	1
TatsuoTsuji	MasayukiKuroda	1
WalidRjaibi	TyroneGrandison	1
Jian-YunNie	DaweiSong	1
KrithiRamamritham	DavidB.Lomet	1
WenfeiFan	PeterBuneman	1
TakayukiShiga	RuiKimura	1
TaneliMielik*inen	FotoN.Afrati	1
Xue-QiangZeng	Ming-WenWang	1
MikaelFortelius	AnttiUkkonen	1
SheilaA.Greibach	JeffreyD.Ullman	1
PaavoArvola	MarkoJunkkari	1
SubramanianArumugam	AbhijitPol	1
ZhenHuaLiu	RaviMurthy	1
TahsinM.Kur*	StephenLangella	1
EvgeniTsivtsivadze	AleksandrMyll*ri	1
XinXu	GaoCong	1
KevinS.Beyer	ChunZhang	1
UweR*hm	Chun-WuChen	1
StefanoCeri	RobertoAcerbis	1
YongguangJiang	JingPeng	1
GuidoMoerkotte	Carl-ChristianKanne	2
JiazhengShi	AshokSamal	1
MitchCherniack	DanielJ.Abadi	1
IsaacChankai	AriD.Brooks	1
RamanathanV.Guha	D.Sivakumar	1
ShiweiTang	MingZhang	1
ZhengShao	XiaofeiHe	1
VanTrangNguyen	KeunHoRyu	1
ChrisClifton	BrettBanich	1
PhilipS.Yu	Ming-SyanChen	1
TakashiWashio	KoutarouNakanishi	1
ShaluGupta	CharlesLoftis	1
PaulNalos	OsmarR.Za*ane	1
SatoshiMorinaga	HirokiArimura	1
SergeyMelnik	PeterMork	1
YufeiTao	WenJin	1
VladislavShkapenyuk	AnastassiaAilamaki	1
TakashiHonishi	HiroyukiUchiyama	1
MayumiUeda	MasayukiKawabata	1
StephenLangella	RenatoFerreira	1
GaurangMehta	CarlKesselman	1
ZunpingCheng	YaqinWang	1
PhilipMaechling	GaurangMehta	1
HuidongJin	GrahamJ.Williams	1
JianzhongLi	HaifengJiang	1
ZhihuaZhang	EdwardY.Chang	1
PhilipMaechling	MarcSpraragen	1
MohamedF.Mokbel	GermanShegalov	1
Sang-WookKim	Jung-ImWon	2
ChristianS.Jensen	AndreasHeuer	2
StephenLangella	JoelH.Saltz	1
J.EliotB.Moss	AlexanderB.Romanovsky	1
ToddEavis	FrankK.H.A.Dehne	1
RicardoVilalta	BruceKnuteson	1
VassilisPapadimos	KristinTufte	2
XiaolingWang	AoyingZhou	2
SandeepMane	CarsonMurray	1
AlakaMullick	A.FazelFamili	1
TomohiroEndo	MasayukiTanimoto	1
YanifAhmad	WenjuanXing	1
VenkateshGanti	SurajitChaudhuri	2
VincentShin-MuTseng	Ming-HsiangWang	1
JiuyongLi	AdaWai-CheeFu	1
SridharGullapalli	JihieKim	1
YolandaGil	MaureenDougherty	1
GiuseppeDeGiacomo	DiegoCalvanese	1
HansChalupsky	EwaDeelman	1
WeiWang0011	QingZhang	1
QiongLuo	FangXiong	1
TakanobuNishiura	AkiraSasou	1
PanosK.Chrysanthis	AlexandrosLabrinidis	1
ToddEavis	AndrewRau-Chaplin	1
RyoTaguchi	AkitsuguWatanabe	2
SusumuDate	KazutoYamazaki	1
SihemAmer-Yahia	DavidToman	1
MarkR.Verardo	AmbujK.Singh	1
ZheShan	QingLi	1
Shi-WeiTang	Cong-RuiJi	1
NgaTran	MitchCherniack	1
ZhipengXie	QingZhang	1
JingMichelleLiu	JayantMadhavan	1
ShashiShekhar	SandeepMane	1
WeiguoFan	AlexandreX.Falc*o	1
RobertoAcerbis	AldoBongio	1
E.VictorS*nchezRebull	A.Est*vezGarc*a	1
TakashiHoshino	KazuoGoda	1
SoonMyoungChung	CongnanLuo	1
TuBaoHo	MinhLeNguyen	1
WisamDakka	PanagiotisG.Ipeirotis	1
Thanh-DuyNguyen	DennisN*rgaard	1
WolfgangFaber	NicolaLeone	1
Hans-J*rgSchek	CanT*rker	1
TakeshiHorie	KenHiguchi	1
MichaelR.Genesereth	AnkitGarg	1
ThanhTinTang	NickCraswell	1
M.Powell	AnthonyJ.Bagnall	1
SivasankaranChandrasekar	RaviMurthy	1
MuLi	JianfengGao	1
ShengnanCong	DavidA.Padua	1
MichaelK.Ng	LinCheung	1
YuchangGong	Wei-YingMa	1
RaghuRamakrishnan	DouglasBurdick	1
MartinAlbrecht	AndreasMeier	1
NihanKesimCicekli	AhmetCosar	1
Zhi-HongDeng	Cong-RuiJi	1
PradeepDubey	GregoryBuehrer	1
LourensVeen	CanT*rker	1
Wen-ChiehYang	Kun-TaChuang	1
MaureenDougherty	KaranVahi	1
JingJiang	ChengXiangZhai	1
WangKayNgai	SunilPrabhakar	1
ThomasA.Russ	HansChalupsky	1
QianShengCheng	BinGao	1
RyanRich	MinhLy	1
SabrinaDeCapitanidiVimercati	CristianoFugazza	1
S.Sudarshan	RushiDesai	1
TakayukiTamura	KulwadeeSomboonviwat	1
Wing-HoShum	ManLeungWong	1
DanieleBraga	AlessandroCampi	1
GiorgioTerracina	BartoszNowicki	1
EricC.Jensen	AleksanderKolcz	1
Zolt*nB*ns*ghi	DomonkosTikk	1
YasuhiroInazumi	TakamichiMiyata	1
XiaomeiYu	KazumiKuriyama-Matsumura	1
PeterJ.Haas	DanielC.Zilio	1
TimW.Nattkemper	AndreasDegenhard	1
YoTakano	RyuichiIshihara	1
JianPei	ChunyuJiang	1
YolandaGil	GurmeetSingh	1
ShobhitMathur	DanSuciu	1
SivasankaranChandrasekar	MuralidharKrishnaprasad	1
XifengYan	JianPei	1
MarcosAndr*Gon*alves	MarcoCristo	1
ThomasEiter	MarcoRuzzi	1
VikasArora	RaviMurthy	1
Phill-KyuRhee	MiYoungNam	1
ToshiakiFujii	TomohiroEndo	1
VolkerTresp	MatthiasSchubert	1
JeffreyScottVitter	AnnChristineCatlin	1
PereAlbert*	AntonioBahamonde	1
TakahiroIkeda	SatoshiMorinaga	1
TakehiroFurudate	HideoMatsuda	1
RobertaCochrane	NormenSeemann	1
ZhengjieZhang	HongjunLu	1
YujiNakagawa	TakashiBaba	1
NoraSpeer	AndreasZell	1
Mich*leSebag	Marie-ChristineRousset	1
XiaolingWang	DunluPeng	1
EricSedlar	DanielaFlorescu	1
ThomasLengauer	DanielHoffmann	1
J.EliotB.Moss	DavidB.Lomet	1
ShengMa	AlinaBeygelzimer	1
RogerS.Barga	GermanShegalov	1
NormanW.Paton	AlvaroA.A.Fernandes	1
YildirayKabak	GokceLaleci	1
J.WennyRahayu	DennisWollersheim	1
Shou-JianYu	Jia-JinLe	2
VeliBicer	AsumanDogac	1
MihaiSurdeanu	AliciaAgeno	1
HyoilHan	AriD.Brooks	1
RobPowers	IraCohen	1
WolfgangFaber	GianluigiGreco	1
PilarHerrero	Jos*M.Pe*aS*nchez	1
ZheweiJiang	Wen-ChiHou	1
VeronicaVinciotti	AllanTucker	1
SerapDurmaz	FatihCoskun	1
R*gisGras	FabriceGuillet	1
ZhaogongZhang	Pang-NingTan	1
YimingYang	HaoWan	1
ShengliSheng	CharlesX.Ling	2
ChristophB*hm	AlexanderBilke	1
JenniferWidom	ChristianS.Jensen	1
TakehisaYairi	KazuoMachida	2
ShigekiMatsubara	NobuoKawaguchi	1
HaifengChen	GuofeiJiang	1
PatrickE.O'Neil	AlexRasin	1
PrasenjitMitra	JaewooKang	1
ChrisJermaine	AbhijitPol	3
OmarKhadeerHussain	BenSoh	1
LeopoldoE.Bertossi	CalistoZuzarte	1
JuanJos*delCoz	JorgeD*ez	1
KoenVanhoof	KennethS*rensen	1
TakehiroFurudate	GenKawamura	1
NavneetPanda	GangWu	1
TakashiHoshino	MasaruKitsuregawa	1
SujataBanerjee	MitchCherniack	1
MichaelSchrefl	KatharinaGr*n	1
TakanobuNishiura	ChiyomiMiyajima	1
PhokionG.Kolaitis	AlexThomo	1
PhilipS.Yu	LingLiu	1
ThomasLengauer	FrancescaCeccherini-Silberstein	1
MincaMramor	BlazZupan	1
HongCheng	DongXin	2
JingPeng	BillP.Buckles	1
ShantanuJoshi	AbhijitPol	2
JeffPollock	DeniseDraper	1
DaehyunKim	AmolGhoting	1
S.AlirezaAghili	DivyakantAgrawal	1
Tie-YanLiu	BinGao	1
SukomalPal	AdityaBagchi	1
VenkataNishanthLolla	StefanoLonardi	1
RuiZhou	HuanHuo	1
ZhenHuaLiu	SusanKotsovolos	1
ShariqRizvi	AnilEdakkunni	1
XuedongChen	MichaelStonebraker	1
JanVandenBussche	EvelineHoekx	1
WeiZhang	GillianDobbie	1
XiangjiHuang	QingsongYao	1
PeerKr*ger	Hans-PeterKriegel	3
VictorTeixeiradeAlmeida	RalfHartmutG*ting	1
XingquanZhu	GongChen	1
WonikChoi	SukhoLee	1
MarcSumner	EibeFrank	1
WenyinLiu	JunYan	1
MartinTheobald	GerhardWeikum	2
KaoruKatayama	Jos*Martinez	1
BinCao	AntonioBadia	1
GeorgGottlob	BartoszNowicki	1
XuedongChen	PatrickE.O'Neil	1
TakehiroFurudate	KazutoYamazaki	1
GianluigiGreco	DomenicoLembo	1
XianghongJasmineZhou	JiaweiHan	2
QiaozhuMei	ChengXiangZhai	2
MartinLorenz	HagenLanger	1
XinXu	AnthonyK.H.Tung	2
TuongC.Truong	HamidPirahesh	1
YongXiaojia	JingPeng	1
NoriyoshiYamauchi	FumihiroKumeno	1
XiaoweiSun	ChendongZou	1
MafruzZamanAshrafi	DavidTaniar	1
WenjuanXing	Ugur*etintemel	1
ShivakumarVaithyanathan	RaghuRamakrishnan	1
WeiJiang	JaideepVaidya	1
KennethS*rensen	GerritK.Janssens	1
DivyakantAgrawal	AhmedMetwally	1
RuiXiao	DouglasHolt	1
MosheY.Vardi	DanielJ.Rosenkrantz	1
W.BruceCroft	JoonHoLee	1
PanagiotisG.Ipeirotis	KennethR.Wood	1
DanielJ.Abadi	AlexRasin	1
Wang-ChienLee	HaiboHu	1
JamesReilly	BarrySmyth	1
MatthewJ.Rattigan	DavidJensen	1
MarkA.Friedl	CarlaE.Brodley	1
LeiShi	ChenLi	1
XiangLi	JosephTerry	1
MeikeKlettke	HolgerMeyer	1
ZhengChen	Wei-YingMa	1
XueqingGong	AoyingZhou	1
XifengYan	HongCheng	3
HenryG.Goldberg	DavidJensen	1
RajeevRastogi	PhilipBohannon	1
RyoTaguchi	DaiKobayashi	2
MustafaAtay	ArtemChebotko	1
VipinGupta	GurmeetSingh	1
RiccardoRosati	DomenicoLembo	2
ZoranObradovic	SlobodanVucetic	1
GabiSchmidberger	EibeFrank	1
MarcosAndr*Gon*alves	EdwardA.Fox	2
ThomasR.Gabriel	A.SimonaPintilie	1
JunyiXie	JunYang0001	2
HiroshiSaruwatari	DaisukeSaitoh	1
ValentinaSvicher	TobiasSing	1
Mal*Castellanos	FabioCasati	2
XueqiCheng	BinWang	1
V*roniqueBenzaken	RaviVijay	1
SunilPrabhakar	ArifGhafoor	1
VeronicaVinciotti	PeterA.C.'tHoen	1
SotirisBrakatsoulas	DieterPfoser	2
XifengYan	DongXin	2
SuryaNepal	PaulGreenfield	1
ShashiShekhar	AnnePusey	1
RavishankarRamamurthy	RaghavKaushik	1
JunXu	DmitriyMeyerzon	1
TerenceHo	LaksV.S.Lakshmanan	1
LiangJin	ChenLi	2
KrithiRamamritham	BrianRandell	1
SanghyunPark	JeeheeYoon	2
XuedongChen	AmersonLin	1
WeiWang0010	JinzeLiu	1
PhokionG.Kolaitis	LeopoldoE.Bertossi	1
RafaelRum*	AntonioSalmer*n	1
HenryF.Korth	GerhardWeikum	1
HiroyukiKitagawa	AkiyoshiNakamizo	1
RajeevRastogi	JianhuaLu	1
XuedongChen	EdmondLau	1
GurmeetSingh	GaurangMehta	1
MelanieHilario	AdamWoznica	1
YoshinobuYamashita	GuanghaoLi	1
TadashiOhmori	GuanghaoLi	1
NikolausAugsten	MichaelH.B*hlen	1
ZhuoChen	WeiZhang	1
Ugur*etintemel	JohnJannotti	1
KennethSalem	DonghuiZhuo	1
SandeepGupta	ChinyaV.Ravishankar	1
ReijiTeramoto	GenKawamura	1
SurajitChaudhuri	RahulKapoor	1
YeowWeiChoong	MaguelonneTeisseire	1
StanleyB.Zdonik	NesimeTatbul	1
DiegoFuxman	ArielFuxman	1
SandeepPandey	JunghooCho	1
WeiningQian	ShoukeQin	1
KazuyaTakeda	KazumasaYamamoto	1
SatoshiNakamura	KazuyaTakeda	1
RalfHartmutG*ting	MarkusSpiekermann	1
TheodoreDalamagas	DimitriTheodoratos	1
JianxinYao	JianLiu	1
PhilipS.Yu	GabrielPuiCheongFung	2
MarkOette	Carlo-FedericoPerno	1
JieYin	Jian-TaoSun	1
StanleyB.Zdonik	NgaTran	1
DaiKobayashi	AkitsuguWatanabe	3
YingLiu	AlokN.Choudhary	1
KenHiguchi	K.M.AzharulHasan	1
WeiningQian	AoyingZhou	3
GiuseppeDeNicolao	FedericoDiPalma	1
MosheY.Vardi	EllisHorowitz	1
KaranVahi	GaurangMehta	1
KrithiRamamritham	HweeHwaPang	1
RichardButterworth	GregoryPiatetsky-Shapiro	1
MatthiasGro*mann	BernhardMitschang	1
WeiYu	AdrianBaras	1
Ricardo*anculef	CarlosValle	1
RaghuRamakrishnan	DavidJ.DeWitt	2
RohitJain	KoustuvDasgupta	1
VasileiosMegalooikonomou	QiangWang	2
YokoMizuta	TonyMullen	1
NaveenAshish	DinaBitton	1
MaartendeRijke	JaapKamps	1
WenjuanXing	MarkHumphrey	1
TranTrang	NguyenCamChi	1
ShigeoSugimoto	AkiyoshiNakamizo	1
GerhardWeikum	AlanFekete	1
TakahiroIkeda	SusumuAkamine	1
JeffreyScottVitter	ArifGhafoor	1
YingXing	NesimeTatbul	1
StanleyB.Zdonik	AmersonLin	1
SilviaChiusano	ElenaBaralis	1
DinaBitton	ArnonRosenthal	1
ElizabethJ.O'Neil	AlexRasin	1
YanpingZhang	TaoWu	1
RichardR.Muntz	PhilipS.Yu	1
NileshN.Dalvi	BhushanMandhani	1
PanayiotisTsaparas	ChristosFaloutsos	1
VanjaJosifovski	BrianVickery	1
Wing-KaiHon	AnnChristineCatlin	1
RobertWarren	EgidioL.Terra	1
MeikeKlettke	BirgerH*nsel	1
MuralidharKrishnaprasad	AnandManikutty	1
JohanPetrini	Jean-LucHainaut	1
YuxinPeng	XiaojunWan	1
ZhengChen	Tie-YanLiu	1
WeiFan	BiancaZadrozny	1
KshirasagarNaik	JieLian	1
GiorgioTerracina	GeorgGottlob	1
YingYan	WeiningQian	1
MatthewPerry	CarticRamakrishnan	1
MarkOette	DanielHoffmann	1
GiuseppeManco	AntonellaGuzzo	1
PanayiotisTsaparas	AlexanderHinneburg	1
WenyinLiu	FengshanBai	1
EricSedlar	Anh-TuanTran	1
PedroLuisP*rezSerano	MarisolS*nchez-Alonso	1
RichardT.Snodgrass	ElisaBertino	1
ToshikiEndo	AkiraSasou	1
GerdF*tkenheuer	FrancescaCeccherini-Silberstein	1
DanielFleder	AdrianBecker	1
RobertLothian	NirmalieWiratunga	1
RongJin	FengKang	1
DavidR.Kaeli	BettySalzberg	1
Mar*aS.P*rez	*scarCubo	1
Yi-PingPhoebeChen	XiaofangZhou	1
CraigA.Knoblock	ClaudeNanjo	1
TuongC.Truong	BertVanderLinden	1
MarcSpraragen	GarrickStaples	1
Yu-huiXing	Tian-yangLv	1
KevinY.Yip	DavidW.Cheung	2
MartinMozina	JanezDemsar	1
ElisaBertino	BengChinOoi	1
PeterDadam	ManfredReichert	1
ParkeGodfrey	JarekGryz	1
QuocLe	BedoorK.AlShebli	1
PhokionG.Kolaitis	ParkeGodfrey	1
AmrElAbbadi	AhmedMetwally	1
VanithaVaradarajan	AnHaiDoan	1
JeffreyXuYu	HongjunLu	5
DavidJensen	*zg*rSimsek	1
San-YihHwang	Jeng-KuenChiu	1
KenroAihara	AtsuhiroTakasu	1
MitchCherniack	AlexandrosLabrinidis	1
WeiNi	TokWangLing	1
RalfSchenkel	JensGraupmann	1
GilbertoC*mara	DaltonM.Valeriano	1
Mar*aS.P*rez	Jos*M.Pe*aS*nchez	1
KristalT.Pollack	DarrellD.E.Long	1
MarcPlantevit	AnneLaurent	1
TakuyaMaekawa	TakahiroHara	1
Hans-J*rgSchek	FuatAkal	1
RandallSalas	DieterPfoser	1
PieroFraternali	MarcoBrambilla	1
RiccardoRosati	MaurizioLenzerini	1
StevenM.Beitzel	OphirFrieder	1
Ren*eJ.Miller	AnastasiosKementsietsidis	1
WalidA.Najjar	DimitriosGunopulos	1
WeiHong	SamuelMadden	1
WingSingWong	Wang-ChienLee	1
XiangyeXiao	HongboFu	1
PhuChienNguyen	HiroshiMotoda	1
TakahiraYamaguchi	HidenaoAbe	1
TobiasScheffer	RolfSchimpfky	1
SathyakamaSandilya	MehmetDundar	1
ClaudioVarini	AndreasDegenhard	1
Shyh-KweiChen	Kun-LungWu	1
LinCheung	KevinY.Yip	1
RicardodaSilvaTorres	ClaudiaBauzerMedeiros	1
IsmailHakkiToroslu	FarukPolat	1
TonyPan	ScottOster	1
DeanKuo	AlanFekete	1
TheoVassilakis	RahulKapoor	1
LingLi	Hsuan-TienLin	1
XiaodongZhou	GiuseppeCarenini	1
ChunZhang	BertVanderLinden	1
PaulNalos	MohammadEl-Hajj	1
RussellL.FinleyJr.	FarshadFotouhi	1
JianPei	DavidWai-LokCheung	1
MiguelFerreira	ElizabethJ.O'Neil	1
YasushiOgawa	ShirohHoribe	1
ZhaoqiChen	DmitriV.Kalashnikov	1
SrinivasanParthasarathy	DaehyunKim	1
YoshinoriSakai	YasuhikoFujisaki	1
SamuelMadden	EdmondLau	1
RyanRich	PengyueJ.Lin	1
WeiFan	KevinDrummey	1
NagaK.Govindaraju	DineshManocha	1
QingLiu	JeffreyXuYu	1
RolfKaiser	MarkOette	1
JeffPollock	ArnonRosenthal	1
Jeong-HyonHwang	BradleyBerg	1
AlinDobra	AbhijitPol	2
VictorTeixeiradeAlmeida	ThomasBehr	1
YolandaGil	JihieKim	1
YidongYuan	WeiWang0011	2
EwaDeelman	CarlKesselman	1
Wen-ChiHou	HongGuo	1
JaideepSrivastava	AnnePusey	1
QunxiaLi	JunGuo	1
Wang-ChienLee	BaihuaZheng	3
StanSclaroff	GeorgeKollios	2
RuomingJin	KaushikSinha	1
SabineRabas*da	RiadhBenMessaoud	1
JuanJos*delCoz	CarlosSa*udo	1
DenisChurin	AdrianBaras	1
NingthoujamGourakishwarSingh	AnjanaK.Mahanta	1
WalidG.Aref	ArifGhafoor	1
YingFeng	Hua-GangLi	1
RichardHull	MichaelA.Harrison	1
ZhengLiu	HongjunLu	1
SridharVaradarajan	KrithiRamamritham	1
RobertoRuiz	NorbertoD*az-D*az	1
HuiZhang0002	FangBian	1
DieterGawlick	BobThome	1
PeterKokol	BrunoStiglic	1
JianshuWeng	AngelaGoh	1
GideonSchaller	EugeneKogan	1
WilliamI.Grosky	JigneshM.Patel	1
JoonHoLee	JiwoonJeon	1
KarlAberer	CyrusShahabi	1
RonaldK.Pearson	RobertJ.Kingan	1
RichardKuntschke	AlfonsKemper	1
DavidJensen	AndrewFast	1
XiaofeiHe	DengCai	1
HuipingCao	DavidW.Cheung	1
KlausHaller	CanT*rker	1
LinCheung	DavidW.Cheung	1
ThomasNeumann	GuidoMoerkotte	1
XinJin	BamshadMobasher	1
Yen-KuangChen	GregoryBuehrer	1
StanMatwin	NathalieJapkowicz	1
WeiyiMeng	ClementT.Yu	3
KoustuvDasgupta	AkshatVerma	1
Yi-HungWu	Ding-YingChiu	1
KenjiYoshihira	CristianUngureanu	1
KaranVahi	GarrickStaples	1
TheodoreJohnson	OliverSpatscheck	1
VasilisMegalooikonomou	Chotirat(Ann)Ratanamahatana	1
RaviKumar	AnirbanDasgupta	1
MinhLy	BehrokhSamadi	1
ZahirTari	KwongYuenLai	1
KedarDhamdhere	ChristopherOlston	1
YuqiangGuan	InderjitS.Dhillon	1
VenkateshRaghavan	KurtW.Deschler	1
VanjaJosifovski	TuongC.Truong	1
EgemenTanin	AaronHarwood	1
TonyGriffiths	AlvaroA.A.Fernandes	1
YanjiangYang	RobertH.Deng	1
DayouZhou	AlinDeutsch	1
JimGray	AlexanderS.Szalay	1
VanjaJosifovski	JimKleewein	1
GuyM.Lohman	GeorgeLapis	1
GiorgioTerracina	EdytaKalka	1
NesimeTatbul	AlexRasin	1
MincaMramor	IvanBratko	1
SurajitChaudhuri	SanjayAgrawal	1
XueminLin	HaifengJiang	1
VarunPandey	SatishTadepalli	1
KellyPalmer	JohnKomoroske	1
BernhardStegmaier	AngelikaReiser	1
Min-YenKan	HoangOanhNguyenThi	1
PatriciaRodr*guez-Gianolli	AnastasiosKementsietsidis	1
MarkoGrobelnik	BlazFortuna	1
XiaoweiSun	RuiWang0002	1
SaneyasuYamaguchi	MachikoToyoda	1
RajeevRastogi	JeffreyXuYu	1
YannisVelegrakis	JohnMylopoulos	1
LeoYungHangLau	EamonnJ.Keogh	1
PhilippR*sch	ChristianvonderWeth	1
VishalSikka	DinaBitton	1
HakanHacig*m*s	BalakrishnaR.Iyer	1
LaurentMignet	AdrianM.Teisanu	1
WitoldStaniszkis	MaurizioLenzerini	1
Kian-LeeTan	BengChinOoi	2
YunyueZhu	GermanShegalov	1
PaulGreenfield	DeanKuo	1
XiaohuiLiu	PeterA.C.'tHoen	1
PatrickBaldasare	MichaelFassino	1
RomanSchmidt	AnwitamanDatta	1
TianYu	JiahengLu	1
PierangelaSamarati	PaoloCeravolo	1
EdmondLau	DanielJ.Abadi	1
RobertoRuiz	Jos*Crist*balRiquelmeSantos	1
FarukPolat	AdnanYazici	1
TapioPahikkala	JormaBoberg	1
MelanieHilario	JulienPrados	2
YunshengLiu	GuoQiongLiao	1
Ren*eJ.Miller	DiegoFuxman	1
HisashiKashima	HiroakiEtoh	1
PeixiangZhao	MingZhang	1
Jian-TaoSun	DouShen	1
JensTeubner	JanRittinger	1
PhilipA.Bernstein	AnHaiDoan	1
SeokJaeLee	JaeSooYoo	1
HananSamet	AaronHarwood	1
JonM.Kleinberg	DeepayanChakrabarti	1
GerdHeber	DavidT.Liu	1
HenryF.Korth	AlexanderB.Romanovsky	1
PanayiotisTsaparas	AristidesGionis	4
UlrichTelle	FrankHoffmann	1
SwaroopK.Chalasani	AmitJ.Shah	1
WenyuanWang	ChongWang0002	1
YannisManolopoulos	AntonisSidiropoulos	1
YujiNakagawa	KazuakiUeda	1
DavidA.Holland	ChakiNg	1
Ugur*etintemel	AlexanderZgolinski	1
XiangyeXiao	DanHong	1
NingLiu	JunYan	1
XuedongChen	AdamBatkin	1
TimothyM.Sutherland	ElkeA.Rundensteiner	1
XuanhuiWang	ChengXiangZhai	1
JeffreyF.Naughton	CurtJ.Ellmann	1
VittorioCastelli	MichailVlachos	2
SlobodanVucetic	KangPeng	1
WeiWang0011	JeffreyXuYu	2
FatihCoskun	DanOlteanu	1
OmarKhadeerHussain	FarookhKhadeerHussain	1
WenfeiFan	PhilipBohannon	2
YongguangJiang	YongXiaojia	1
SunilPrabhakar	ChristopherW.Clifton	1
XingzhiSun	MariaE.Orlowska	2
AnHaiDoan	AlonY.Halevy	1
YanjiangYang	BengChinOoi	1
SpiridonBakiras	Shen-TatGoh	1
XinDong	JayantMadhavan	1
GianluigiGreco	FrancescoScarcello	1
ZacharyG.Ives	HolgerMeyer	1
KeWang	HaixunWang	1
VolkerMarkl	PeterJ.Haas	2
DunjaMladenic	BlazFortuna	1
WeiWang0010	AndrewB.Nobel	1
ElenaMessina	ChrisScrapper	1
XueLi	MariaE.Orlowska	1
JensBleiholder	AlexanderBilke	1
BengChinOoi	BarbaraCatania	1
MihaGrcar	MarkoGrobelnik	1
ZhenjieZhang	AnthonyK.H.Tung	1
LinGuo	EugeneJ.Shekita	1
TakahideNogayama	TadashiTsumura	1
RolfKaiser	Carlo-FedericoPerno	1
JaewooKang	DongwonLee	1
J.D.Garc*aLuna	E.VictorS*nchezRebull	1
KrithiRamamritham	AparnaNagargadde	1
Jos*Mar*aCavero	DianaM.S*nchezFuquene	1
RadaChirkova	CharlesLoftis	1
YujiNakagawa	KanameAmano	1
PhilippeBonnet	ChristofferHall	1
S*rgioLifschitz	Rog*rioLu*sdeCarvalhoCosta	1
StephenLangella	ScottOster	1
SihemAmer-Yahia	PatCase	1
Fran*oisBry	FatihCoskun	1
YongtaiZhu	BaileShi	1
SpirosPapadimitriou	JimengSun	2
WolfgangFaber	VincenzinoLio	1
ShreeRaman	MukeshK.Mohania	1
SoumenChakrabarti	RushiDesai	1
StratisViglas	PeterBuneman	1
YosukeSakao	TakahiroIkeda	1
TaoTao	QiaozhuMei	1
XinLi	HuiZhang0002	1
ThomasEiter	EdytaKalka	1
MehrdadJahangiri	DimitrisSacharidis	1
EwaDeelman	BrianMendenhall	1
IsidroRamos	AbelG*mez	1
KevinS.Beyer	BertVanderLinden	2
SilviuCucerzan	EugeneAgichtein	1
YaqinWang	NingShang	1
SubramanianArumugam	ChrisJermaine	1
SukhoLee	JoonhoKwon	1
WonsukLee	DaesuLee	1
TakeshiFushimi	Shin'ichiWakabayashi	1
SatoshiOyama	KatsumiTanaka	1
Pin-KwangEng	Kian-LeeTan	2
Sang-WookKim	JeeheeYoon	2
ZhenjieZhang	HuaLu	1
RaghuRamakrishnan	Per-*keLarson	1
ZujiaXu	JingPeng	1
TakehiroFurudate	ShinjiShimojo	1
OliverSeeliger	MichaelRys	1
ShivakumarVaithyanathan	PrasadDeshpande	1
RichardT.Snodgrass	PhilipA.Bernstein	2
MarcosAntonioVazSalles	MairaFerreiradeNoronha	1
MichaelRys	AdrianBaras	1
HongjunLu	AoyingZhou	1
SameepMehta	HuiYang	2
JihadBoulos	BhushanMandhani	1
MuralidharKrishnaprasad	EricSedlar	1
Ding-YingChiu	Chih-HsiangLin	1
YuanyuanJia	ClementT.Yu	1
TakashiTomokiyo	MatthewHurst	1
XiangyeXiao	QiongLuo	1
ThaiQuangTung	Jong-TaeLim	1
XiaoyuanWang	QingZhang	1
PanayiotisTsaparas	GautamDas	1
MuralidharKrishnaprasad	Anh-TuanTran	1
XiaochunYang	GeYu	1
YeowWeiChoong	DominiqueLaurent	1
KathleenM.Carley	EdoardoAiroldi	1
MartinKempa	BedaChristophHammerschmidt	1
SandeepGupta	JinfengNi	1
NikosKyrpides	KrishnaPalaniappan	1
YunboCao	JunXu	1
ShenjieLi	DmitriyMeyerzon	1
MichalisVazirgiannis	DimitriosGunopulos	1
SerapDurmaz	Fran*oisBry	1
RobertoRuiz	Jes*sS.Aguilar-Ruiz	1
Yong-HeeLee	Byung-KyuKim	1
GiulianoTirenni	AbderrahimLabbi	1
XuanZhou	HweeHwaPang	1
NipunAgarwal	EricSedlar	1
ThomasLengauer	MarkOette	1
FabianM*rchen	AlfredUltsch	1
KaziA.Zaman	DonovanA.Schneider	1
RedaAlhajj	AnthonyLo	1
JunXu	JoshuaZhexueHuang	1
MihaGrcar	BlazFortuna	1
YingjiuLi	XintaoWu	1
PasiLehtim*ki	KimmoRaivio	1
JordiCabot	ErnestTeniente	1
MasaruKitsuregawa	KulwadeeSomboonviwat	1
TongLuo	LawrenceO.Hall	1
QingZhang	QingLiu	1
YongZhao	LucMoreau	1
XinZheng	BinGao	1
ZiyingLiu	A.FazelFamili	1
Yi-fangBrookWu	XinChen	3
AnthonyD.Nguyen	AmolGhoting	1
SurajitChaudhuri	GerhardWeikum	1
MouradOuzzani	ArifGhafoor	1
SimonChong	PaulAndrewWatters	1
MitchCherniack	EdmondLau	1
UlrichTelle	RalfHartmutG*ting	1
YufeiTao	QingLi	1
NicolaLeone	GeorgGottlob	1
D.Sivakumar	AndrewTomkins	1
VipinKumar	VarunChandola	1
TharamS.Dillon	FarookhKhadeerHussain	1
S.Sudarshan	RavindraGuravannavar	1
SotirisBrakatsoulas	CarolaWenk	1
WingHungWong	SijinLiu	1
SundarSaiprasad	KevinS.Beyer	1
StevePoteet	AnneKao	1
ZhiyongPeng	ZheShan	1
RomanSchmidt	KarlAberer	1
TolgaBozkaya	AmanNaimat	1
HaiboHu	BaihuaZheng	1
ZhihuaCai	JiangSu	1
PatrickGallinari	MouniaLalmas	1
FrankHoffmann	DirkAnsorge	1
MarcosAntonioVazSalles	Jens-PeterDittrich	1
Jean-LucHainaut	CarmenCostilla	1
MohammedJaveedZaki	BartGoethals	1
SurajitChaudhuri	BrianBabcock	1
LucBouganim	CosminCremarenco	1
KjetilN*rv*g	AlbertOverskeidNyb*	1
RolfKaiser	J*rgenK.Rockstroh	1
UlrichG*ntzer	JasonXinZheng	1
HolgerMeyer	AndreasHeuer	2
TonyGriffiths	NormanW.Paton	1
PaulAndrewWatters	MichaelHitchens	1
WeiyiMeng	FangLiu	1
MehranSahami	EllenSpertus	1
GuyM.Lohman	Fatma*zcan	1
VipinGupta	BrianMendenhall	1
VictorVianu	JeffreyD.Ullman	1
TakeshiYamada	KazuyaTakeda	1
YeowWeiChoong	AnneLaurent	1
YihengLi	SamuelEdoho-Eket	1
YingChen	AndrewRau-Chaplin	1
MohamedF.Mokbel	AbdelsalamHelal	1
TorstenGrust	JensTeubner	1
NingLi	NadavEiron	1
ThomasA.Russ	KaranVahi	1
HengTaoShen	BengChinOoi	1
PohsanLai	LimsoonWong	1
SivasankaranChandrasekar	EricSedlar	1
Kian-LeeTan	GaoCong	1
ClaudiaBauzerMedeiros	Andr*Santanch*	1
RaymondJ.Mooney	JoydeepGhosh	1
JianyongWang	GeorgeKarypis	1
SusanKotsovolos	EricSedlar	1
YokoKamidoi	TomotakeNakamura	1
Kai-UweSattler	IngolfGeist	1
MarcosAntonioVazSalles	DonaldKossmann	1
StevenM.Beitzel	DavidD.Lewis	1
JunYang0001	AdamSilberstein	1
PatrickGallinari	NicolasUsunier	1
SandeepPandey	ChristopherOlston	1
RobertWingPongLuk	Fu-LaiChung	1
TaoTao	HakanFerhatosmanoglu	1
EmreErdogan	AlinaBeygelzimer	1
MaurizioAtzori	DinoPedreschi	2
G*rardGovaert	ChristopheAmbroise	1
TuongC.Truong	RobertaCochrane	1
SankarSubramanian	AndrewWitkowski	2
NingLiu	FengshanBai	1
ShaofengBu	RaymondT.Ng	1
JinyanLi	JianPei	1
MehmetKeskin*z	AliInan	1
Ming-ChuanWu	BalajiRathakrishnan	1
JeffreyXuYu	GabrielPuiCheongFung	2
MakotoTakaki	KeiichiTamura	1
WeiyiMeng	OphirFrieder	1
JamesW.Warner	AnandManikutty	1
SrikanthSampath	PhilShaw	1
RolfKaiser	HaukeWalter	1
ZhengShao	XifengYan	1
NathanBurkhart	AnilEdakkunni	1
XifengYan	XianghongJasmineZhou	2
XifengYan	BaileShi	1
NingZhang0002	M.Tamer*zsu	1
MichaelGuppenberger	BurkhardFreitag	1
YingFeng	AmbujK.Singh	1
TsuyoshiId*	HisashiKashima	1
ScottLogan	PaulBird	1
MikaNakaoka	KatsumiTanaka	1
YasuhikoMorimoto	MihoMokuda	1
SankarSubramanian	AllisonWaingold	1
EricC.Jensen	AbdurChowdhury	1
ShigehikoKanaya	Md.Altaf-Ul-Amin	1
VipinKumar	AleksandarLazarevic	1
XiaohuaZhou	AriD.Brooks	1
ZonghuanWu	ClementT.Yu	1
XindongWu	StephenJ.Maybank	1
SimonCorston-Oliver	EricK.Ringger	1
SatishTadepalli	ChrisBailey-Kellogg	1
PradeepDubey	AnthonyD.Nguyen	1
TovaMilo	AnatEyal	1
ChunxiaoXing	ChaoLi	1
HaifengChen	CristianUngureanu	1
ShashiShekhar	CarsonMurray	1
MikeFoedisch	CraigSchlenoff	1
MichaelGamon	EricK.Ringger	1
DavidGibson	AndrewTomkins	1
SwaroopK.Chalasani	MoninderSingh	1
Jean-Fran*oisBoulicaut	C*lineRobardet	1
ShingoKuroiwa	SatoshiNakamura	1
ShengMa	IrinaRish	1
KennethC.Sevcik	CalistoZuzarte	1
NickCraswell	DavidHawking	1
OphirFrieder	AleksanderKolcz	1
XavierBonnaire	MichaelMoossen	1
MadhuChetty	ChiaHueyOoi	1
DanielJ.Abadi	AmersonLin	1
SpirosPapadimitriou	HeikkiMannila	1
MyraSpiliopoulou	BrijM.Masand	1
SunghwanMin	IngooHan	1
JayavelShanmugasundaram	FlipKorn	1
KaranVahi	JihieKim	1
RyuichiIshihara	KojiIwanuma	1
VivekR.Narasayya	SurajitChaudhuri	2
MarkHumphrey	AnuragMaskey	1
IanDavidson	BiancaZadrozny	1
WaiLam	Tak-LamWong	2
Zhi-HuaZhou	SongcanChen	1
SunilMovva	BilahariAkkiraju	1
YangyongZhu	JiankuiGuo	1
VictorVianu	MosheY.Vardi	1
NikoBeerenwinkel	DanielHoffmann	1
ZheShan	YiLuo	1
PatrickGallinari	AnastasiosTombros	1
KellyPalmer	JenniferNeville	1
MarcelinoPereiradosSantosSilva	DaltonM.Valeriano	1
YuguoChen	JunYang0001	1
OguzhanTopsakal	JoachimHammer	1
RameshGovindan	KarlAberer	1
NaotoMukai	MasakazuIkezaki	1
JihieKim	EwaDeelman	1
Wing-KaiHon	ChristopherW.Clifton	1
ZhihuaCai	HarryZhang	1
WalidRjaibi	ScottLogan	1
NanWang	AnthonyK.H.Tung	1
ToshiakiFujii	MasayukiTanimoto	1
GianluigiGreco	DomenicoSacc*	1
WolfSiberski	UweThaden	1
ShengquanWang	NanZhang0004	1
RicardoSilva	JamesG.Shanahan	1
LeiSheng	AbhinavGupta	1
Yi-HungWu	Chih-HsiangLin	1
TolgaBozkaya	AbhinavGupta	1
MehmetDundar	JinboBi	1
GideonSchaller	BrandonBerg	1
Jos*deJes*sP*rezAlc*zar	Andr*Santanch*	1
MichiharuKudo	JussiMyllymaki	1
GerhardWeikum	CliffB.Jones	1
IstvanCseri	DraganTomic	1
ZacharyG.Ives	PhilipA.Bernstein	1
IsmailHakkiToroslu	AdnanYazici	1
QiangYang	DongZhuang	1
YaBingChen	Mong-LiLee	1
SunilPrabhakar	BenKao	2
YannisVelegrakis	Ren*eJ.Miller	1
NikosKyrpides	ErnestSzeto	1
YingXing	Jeong-HyonHwang	2
ZhenHuaLiu	VikasArora	3
RamakrishnaGummadi	CyrusShahabi	1
ShigeoSugimoto	Jun'ichiTanaka	1
WeiWang0010	FengPan	1
Jan-MingHo	In-YeeLee	1
MehediMasud	LeiJiang	1
M.Tamer*zsu	HolgerMeyer	2
MouniaLalmas	Massih-RezaAmini	1
MarioA.Nascimento	J*rgSander	3
VasilisMegalooikonomou	QiangWang	1
KarstenM.Borgwardt	Hans-PeterKriegel	1
LiyingSui	AlinDeutsch	1
MasaruKitsuregawa	KazuoGoda	1
BrijM.Masand	BamshadMobasher	1
PhokionG.Kolaitis	AndrewTomkins	1
SihemAmer-Yahia	Am*lieMarian	2
MichaelPhilippsen	IngridFischer	1
VebjornLjosa	Jia-YuPan	1
WitoldStaniszkis	GianluigiGreco	1
ShantanuGodbole	GaneshRamakrishnan	1
ChristosFaloutsos	AmbujK.Singh	1
MartinD*umer	J*rgenK.Rockstroh	1
MingqiangChen	MasatoshiYoshikawa	1
TonyGriffiths	Seung-HyunJeong	1
XifengYan	ChaoLiu0001	1
WeiminXiao	KaidiZhao	2
MariaCarolinaMonard	GustavoE.A.P.A.Batista	1
VijayKumar	MitchCherniack	1
MarcosM.Campos	BorianaL.Milenova	1
YasuyukiShirai	HiroshiInujima	1
Yi-ChengTu	AlanKwan	1
RanWolff	AssafSchuster	1
Rog*riodeLemos	J.EliotB.Moss	1
ShipengYu	Hans-PeterKriegel	2
ZhiyuanChen	JayavelShanmugasundaram	1
ShoukeQin	AoyingZhou	1
Yong-HeeLee	JongHyunPark	1
XiaonanJi	JamesBailey	1
Pang-NingTan	JingGao	1
MitchCherniack	ElizabethJ.O'Neil	1
Yi-HongChu	Kun-TaChuang	1
Juan-CarlosJusem	JosephTerry	1
SunilMovva	JosephTerry	1
OliverPo	DivyakantAgrawal	1
ZoranObradovic	KangPeng	1
StanleyB.Zdonik	MichaelStonebraker	3
SushilK.Prasad	ShamkantB.Navathe	1
ShingoKuroiwa	AkiraSasou	1
MichailVlachos	EamonnJ.Keogh	1
ZhihaoZhang	JianminWang	1
ShravanChamakura	AkshayaArora	1
NathanFolkert	LeiSheng	1
SrinivasanParthasarathy	HuiYang	2
RongChen	EdwardHerskovits	1
NadavEiron	EugeneJ.Shekita	1
DanieleBraga	AlessandroRaffio	1
SridharGullapalli	GaurangMehta	1
MiguelFerreira	AlexRasin	1
MineichiKudo	AtsuyoshiNakamura	2
NaizhenQi	MichiharuKudo	1
ThomasBehr	FrankHoffmann	1
MichaelSchrefl	J*rgenDorn	1
GilbertoZontaPastorelloJr.	EdmundoRobertoMauroMadeira	1
SharmaChakravarthy	AlpaSachde	1
MarkHumphrey	AnjaliJhingran	1
RichardHull	DanielJ.Rosenkrantz	1
JimengSun	HuimingQu	2
TaizoYamada	AtsuhiroTakasu	1
WeiYu	EugeneKogan	1
WenxinLiang	HaruoYokota	1
JensBleiholder	ChristophB*hm	1
HiroshiIshikawa	ErwanLoisant	1
RiccardoMartoglia	EnricoRonchetti	1
Yu-huiXing	ShaobinHuang	1
RicardodaSilvaTorres	AlexandreX.Falc*o	1
JieGao	J*rgDenzinger	1
WenyinLiu	LeefengChien	1
PhilippeThiran	CarmenCostilla	1
GaurangMehta	GarrickStaples	1
TariqulHoque	CarsonKai-SangLeung	1
KennethA.Ross	AngelJanevski	1
GiuseppeManco	GianluigiGreco	1
UllasNambiar	SubbaraoKambhampati	1
SunilPrabhakar	JianzhongSun	1
KennethA.Ross	JunYang	1
XiaoyanLi	W.BruceCroft	1
YanqingZhang	MinSong	1
Chun-NanHsu	Bou-HoYang	1
MichalisVazirgiannis	MartinTheobald	1
KunZhang	BillP.Buckles	1
ShojiroNishio	HidekazuMatsunam	1
RicardodaSilvaTorres	EdmundoRobertoMauroMadeira	1
AsumanDogac	AdnanYazici	1
Mois*sGoldszmidt	IraCohen	1
RaghuRamakrishnan	KristenLeFevre	1
DavidToman	Am*lieMarian	1
Seung-HyunJeong	NormanW.Paton	1
ZhimingDing	VictorTeixeiradeAlmeida	1
ShinichiUeshima	MasayukiKawabata	1
XueqiCheng	SongboTan	1
SamuelMadden	ElizabethJ.O'Neil	1
VenkateshGanti	RahulKapoor	1
ThomasLegler	SebastianSch*r	1
SunilMovva	StevenGreco	1
MartinH.C.Law	AnilK.Jain	1
WolfgangM*ller0002	MartinEisenhardt	1
SebastianH.R.Wurst	MatthiasRenz	1
ArturBoronat	AbelG*mez	1
KaoruKatayama	HiroshiIshikawa	1
S*rgioLifschitz	MarcosAntonioVazSalles	1
Min-SooKim0002	Min-JaeLee	2
PeterTriantafillou	IoannisAekaterinidis	1
HansChalupsky	CarlKesselman	1
YufeiTao	BenKao	1
SamuelMadden	AlexRasin	1
TilmannF.W.Bruckhaus	ShengliSheng	1
NaveenAshish	MichaelJ.Carey	1
NikosMamoulis	ManLungYiu	2
TsuyoshiId*	HiroakiEtoh	1
RolfKaiser	MartinD*umer	1
KellyPalmer	DavidJensen	1
MaguelonneTeisseire	AnneLaurent	1
ZujiaXu	KunZhang	1
MohammedJaveedZaki	LizhuangZhao	1
VolkerLinnemann	BedaChristophHammerschmidt	1
MingZhang	Cong-RuiJi	1
PatrickE.O'Neil	EdmondLau	1
Jos*A.Cars*	AbelG*mez	1
TakahideNogayama	HiroakiEtoh	1
YuxinChen	WeiguoFan	1
KeithT.Mason	AlvaroA.A.Fernandes	1
RaduProdan	MarekWieczorek	1
TakuyaUkon	KenHiguchi	1
PhilipS.Yu	JianLiu	1
M.Tamer*zsu	LukaszGolab	1
ToshinariIida	HiroyukiKitagawa	1
VolkerMarkl	TamMinhTran	1
NingLiu	BenyuZhang	1
MitsunoriMizumachi	KazumasaYamamoto	1
GuozhuDong	ChunyuJiang	1
IstvanCseri	EugeneKogan	1
WeiWang0010	JingdanZhang	1
Tat-SangChoy	SameepMehta	1
UlrichKreher	ManfredReichert	1
XiaojianZhao	RichardCole	1
TatjanaWelzer-Druzovec	PetraPovalej	1
Kian-LeeTan	DanLin	1
Ming-WenWang	Jian-YunNie	1
SergeAbiteboul	IoanaManolescu	1
M.Tamer*zsu	Kyu-YoungWhang	2
TatsuoTsuji	TakuyaUkon	1
YingFeng	AmrElAbbadi	2
MichaelD.Morse	JigneshM.Patel	1
NikoBeerenwinkel	GerdF*tkenheuer	1
MehediMasud	AnastasiosKementsietsidis	1
TobiasSing	Carlo-FedericoPerno	1
ZhiqiangYang	ShengZhong	2
ShankarPal	GideonSchaller	1
WeiWang0011	HongzhiWang	1
SridharGullapalli	EwaDeelman	1
KevinS.Beyer	GeorgeLapis	1
RobertF.Murphy	ChristosFaloutsos	1
RyoNishide	MayumiUeda	1
StanleyB.Zdonik	MitchCherniack	1
RichardT.Snodgrass	Kyu-YoungWhang	2
GuorenWang	ChuanYang	1
XiangdongHe	SenmiaoYuan	1
ValentinaSvicher	FrancescaCeccherini-Silberstein	1
JanParedaens	JanHidders	1
LeiChen0002	JieLian	1
QiongLuo	ByronChoi	1
SebastianH.R.Wurst	Hans-PeterKriegel	1
JinfengNi	ChinyaV.Ravishankar	1
Shu-ChingChen	NaZhao	1
MichaelA.Harrison	EllisHorowitz	1
MaureenDougherty	GurmeetSingh	1
VaishaliHegde	KajalT.Claypool	1
GerhardWeikum	AlexanderB.Romanovsky	1
WeifengLi	KatunobuItou	1
GregoryPiatetsky-Shapiro	DanA.Simovici	1
YoshitoTobe	KenjiSasaki	1
HirokiShirato	GregoryC.Sharp	1
UmeshwarDayal	Mal*Castellanos	1
OlfaNasraoui	BrijM.Masand	1
MaurizioAtzori	FrancescoBonchi	2
KazumasaYamamoto	AkiraSasou	1
XinyuGuo	AnthonyK.H.Tung	1
MartinH.C.Law	AlexanderP.Topchy	1
KunZhang	JingPeng	1
HongzhiWang	HongjunLu	1
PeterTriantafillou	MatthiasBender	1
Jin-HaKim	ChitaR.Das	1
TimFurche	SerapDurmaz	1
ImanS.H.Suyoto	AlexandraL.Uitdenbogerd	1
StanleyB.Zdonik	DanielJ.Abadi	1
ToshinariIida	ShigeoSugimoto	1
OlgaPapaemmanouil	AlexRasin	1
PauloBrazGolgher	BrunoP*ssas	1
RaghuKrishnapuram	KrishnaKummamuru	1
ZhipengXie	WynneHsu	1
YiLi	MohammadEl-Hajj	1
YaboXu	PhilipS.Yu	2
Kyu-YoungWhang	ChristianS.Jensen	2
ElenaMessina	CraigSchlenoff	1
QuangHieuVu	BengChinOoi	1
ShingoKuroiwa	NorihideKitaoka	1
MichaelFink	GeorgGottlob	1
ThomasM.Tirpak	KaidiZhao	2
TakashiSato	HitoshiNakakubo	1
ShingoKuroiwa	ChiyomiMiyajima	1
J*rgSander	AlexandruComan	2
YingZhao	GeorgeKarypis	1
PatrickE.O'Neil	NgaTran	1
Willem-JanvandenHeuvel	CarmenCostilla	1
EfstratiosGallopoulos	DimitriosZeimpekis	1
SathyakamaSandilya	GlennFung	2
PauloBrazGolgher	NivioZiviani	1
NaiyanaTansalarak	KajalT.Claypool	1
MiguelFerreira	DanielJ.Abadi	1
YizhouWang	CarloZaniolo	1
ElizabethChang	BenSoh	1
YasunoriIshihara	KenjiHashimoto	1
WeiHong	GianlucaIannaccone	1
ShuangLiu	FangLiu	1
MehediMasud	IlujuKiringa	1
StavrosPolyviou	GeorgeSamaras	1
YidongYuan	XueminLin	2
VolkerMarkl	DanielC.Zilio	1
TakanobuNishiura	KazumasaYamamoto	1
Ricardo*anculef	ClaudioMoraga	1
RaghuRamakrishnan	HongfeiGuo	1
RobinD.Burke	BamshadMobasher	2
JenniferG.Dy	DavidR.Kaeli	1
CarlFr*licot	AlexisJoly	1
TonyF.Chan	ChrisH.Q.Ding	1
Hua-GangLi	AmrElAbbadi	1
PetkoBakalov	MariosHadjieleftheriou	1