TsutomuTerada	MasahikoTsukamoto	1
XinyuGuo	Mong-LiLee	1
IsabelF.Cruz	A.Howard	1
TovaMilo	OmarBenjelloun	2
RongPan	LiDing	1
JananT.Eppig	JamesA.Kadin	1
GerhardHeyer	ChristianBiemann	1
EricLo	ChiLapYip	1
MuratKantarcioglu	JiashunJin	1
WilliamPerrizo	MasumSerazi	1
WagnerMeiraJr.	RenatoFerreira	1
ChristianHalaschek-Wiener	AmitP.Sheth	1
WenshengWu	WeiyiMeng	1
GaoCong	BingLiu	1
KrishnaG.Kulkarni	AndrewEisenberg	1
JunFang	Jos*A.Blakeley	1
YirongXu	AmyWang	1
Yi-ChengTu	AhmedK.Elmagarmid	1
HaofengZhou	DingZhou	1
PaulWatson	DesmondJ.Fitzgerald	1
SteffenStaab	PhilippeCudr*-Mauroux	1
MohamedH.Ali	AhmedK.Elmagarmid	1
Zhi-LiWu	ChunHungLi	1
MichaelF.Worboys	A.Howard	1
LeiChen0003	DavidR.Musicant	1
ShankarPal	LeoGiakoumakis	1
FabrizioSebastiani	AlbertoLavelli	1
PadhraicSmyth	MichalRosen-Zvi	1
NagaK.Govindaraju	BrandonLloyd	1
KarinKailing	ChristianB*hm	2
WesleyW.Terpstra	LudgerFiege	1
TokWangLing	HaiH.Wang	1
HailingYu	AmrElAbbadi	1
YanzanZhou	XinJin	1
VasiliVasiliZolotov	OliverSeeliger	1
MichalRosen-Zvi	MarkSteyvers	1
RobertNichol	AndrewConnolly	1
YirongYang	YiXia	1
WeiFan	HaixunWang	2
RobertGwadera	MohamedG.Elfeky	1
MichaelBiwer	GerhardWeikum	1
DavidB.Lomet	BettySalzberg	1
SeanC.Rhea	SamMardanbeigi	1
JuanD.Vel*squez	HiroshiYasuda	1
ZhihengLi	HongjunLu	1
St*phaneBressan	AnnaMaddalena	1
YannisPapakonstantinou	AndreyBalmin	1
ToniUrp*	CarlesFarr*	1
YunZhou	StephenCronen-Townsend	1
XiaoweiJiang	GideonSchaller	1
KeesJong	J*r*mieMary	1
RobertGwadera	MohamedY.Eltabakh	1
LowellRosen	EricBloedorn	1
CarterButts	AmnonMeyers	1
MartinPfeifle	MarcoP*tke	2
MuneakiOhshima	ChunnianLiu	1
JamesJ.Schauer	DavidR.Musicant	1
RemaAnanthanarayanan	RahulGupta	1
XiZhang	LiangHuaiYang	1
LowellRosen	JianpingZhang	1
DiegodiBernardo	AngeloCiaramella	1
SumitNegi	RaghuKrishnapuram	1
Hye-YoungPaik	ChristopheRey	2
YunPeng	PavanReddivari	1
ThomasReichherzer	AnaGabrielaMaguitman	1
Mich*leSebag	AntoineCornu*jols	1
NuweeWiwatwattana	LaksV.S.Lakshmanan	1
LudgerFiege	AlejandroP.Buchmann	1
VolkerMarkl	PaulG.Brown	1
JunFang	ChristianKleinerman	1
TakashiWashio	AkihiroNakashima	1
WeiyunHuang	LeoMark	1
K.Karun	JinyuWang	1
SiegfriedNijssen	JoostN.Kok	1
Mich*leSebag	AlexandreTermier	1
WitoldLitwin	ThomasJ.E.Schwarz	2
MiteshVasa	HillolKargupta	1
KarimBa*na	AgnieszkaRutkowska	1
Chia-HsiungLee	ArbeeL.P.Chen	1
RyanHuebsch	IonStoica	2
RobertFiedler	MarianneWinslett	1
TheodoreJohnson	S.Muthukrishnan	1
Y*celSaygin	StanleyR.M.Oliveira	1
SrinivasanParthasarathy	RenatoFerreira	1
Ming-SyanChen	Hung-YuKao	1
MohamedH.Ali	MohamedF.Mokbel	1
JingLiu	FangLiu	1
XintaoWu	KalpathiR.Subramanian	1
Maria-EstherVidal	JensBleiholder	1
ShuichengYan	HuaLi	1
RamaswamyHariharan	HaiminLee	1
LetiziaTanca	CristianaBolchini	1
SophieChabridon	G*r*meCanals	1
RenatoFerreira	AdrianoVeloso	1
KeWang	JeffreyXuYu	1
WenQiangWang	BarbaraCatania	1
JulienVinel	Jean-YvesGarinet	1
BeiYu	AtulyaVelivelli	1
RaghuRamakrishnan	RaghavKaushik	2
HiroyukiKitagawa	CuiZhu	1
JiyingWang	FrederickH.Lochovsky	1
RaymondT.Ng	AnthonyK.H.Tung	1
XiaobinMa	VipinKumar	1
WonSukLee	NamHunPark	1
JiaweiHan	HectorGonzalez	1
GiancarloRaiconi	AntoninoStaiano	1
YiChen	LiangHuaiYang	1
GianniCosta	AndreiArion	1
PhilippeCudr*-Mauroux	EduardoMena	1
IoannisTsoukalas	FangLi	1
JasonTsong-LiWang	CathyH.Wu	1
MinglongShao	JiriSchindler	1
YaboXu	KeWang	1
SalvatoreRinzivillo	FrancoTurini	1
WalidG.Aref	IbrahimKamel	1
SusanGauch	DevanandRavindran	1
Agn*sVoisard	A.Howard	1
RichardTibbetts	EduardoF.Galvez	1
PhilipS.Yu	JianyongWang	2
M.Tamer*zsu	BenjaminBinYao	1
MasonBendixen	GideonSchaller	1
MartinRingwald	JamesA.Kadin	1
WeiWang0009	HaofengZhou	2
MayankBawa	GaganAggarwal	1
ShankarKrishnan	JatinChhugani	1
NinaMishra	DilysThomas	1
XifengYan	JiaweiHan	2
XiangminJiao	RobertFiedler	1
WilfredNg	LinDeng	1
T.Hirsim*ki	EllaBingham	1
Mi-YenYeh	Bi-RuDai	1
RuihuaSong	HaifengLiu	1
ElisaQuintarelli	ElenaBaralis	1
OlgaDeTroyer	EduardoMena	1
TongZhang	KristinP.Bennett	1
RaviJanardan	JiepingYe	2
Hua-JunZeng	EdwardA.Fox	1
FangChu	CarloZaniolo	2
KristenLeFevre	AmeetKini	1
MatthiasBender	ChristianZimmer	1
YaxiaoSong	HonggaLi	1
IoanaManolescu	AngelaBonifati	1
WalidG.Aref	MiretteS.Marzouk	1
SilviaNittel	Agn*sVoisard	1
YiyuYao	MuneakiOhshima	2
MathiasM*rschel	GuyM.Lohman	1
MichaelJ.Franklin	AnastassiaAilamaki	1
ZhengxinChen	GangKou	1
PhilipA.Bernstein	GerhardWeikum	1
Wei-YingMa	EdwardA.Fox	1
IriniFundulaki	BharatKumar	1
LucyChernobrod	AravindYalamanchi	1
JingHu	BinCui	1
Zo*Lacroix	St*phaneBressan	1
JulianaFreire	FangDu	1
XiaoweiJiang	ChristianKleinerman	1
XiaojianZhao	DennisShasha	1
KenichiYoshida	HiromitsuFujikawa	1
HillolKargupta	ChrisGiannella	1
RakeshAgrawal	DavidJ.DeWitt	1
JunHuan	JiongYang	1
WolfgangLindner	SamuelMadden	1
QiangYang	BenyuZhang	3
LatifurKhan	AnneKao	1
Ren*eJ.Miller	LucianPopa	1
YiXia	RichardR.Muntz	1
KristenLeFevre	DianaZhou	1
KristinP.Bennett	JinboBi	1
SihemAmer-Yahia	ChavdarBotev	1
GabrielM.Kuper	EnricoFranconi	2
SharadMehrotra	QiHan	1
OmerZaafrany	AbrahamKandel	1
RichardA.Hankins	JigneshM.Patel	1
TeruakiHomma	AkihiroNakashima	1
XiaoliLi	RohitJoshi	1
PeterCarlin	AlazelAcheson	1
ShashikalaTapaswi	RameshChandraJoshi	1
KemalAltintas	CharlesHuyck	1
JafarAdibi	HansChalupsky	1
RichardTibbetts	ArvindArasu	1
HongxingHe	GrahamJ.Williams	1
VagelisHristidis	AndreyBalmin	1
V.S.Subrahmanian	EdwardHung	1
VivekR.Narasayya	ArunprasadP.Marathe	1
HongjunLu	GuimeiLiu	1
ShariqRizvi	MichaelJ.Franklin	2
TomonariMasada	AtsuhiroTakasu	1
PedroDomingos	AnHaiDoan	1
RaduSion	MikhailJ.Atallah	2
PaulG.Brown	AshrafAboulnaga	1
EduardoMena	ArisM.Ouksel	1
ErikG.Hoel	DimitrisPapadias	1
ArvindArasu	AnuragMaskey	1
ChristosFaloutsos	BinLiu0002	1
YusukeSuzuki	TomoyukiUchida	1
MarkusSchneider	JoachimHammer	1
RachidGuerraoui	PascalMolli	1
RonenFeldman	MosheFresko	1
MaryF.Fern*ndez	J*r*meSim*on	1
VijayshankarRaman	IvanPopivanov	1
MartinH.C.Law	AnaL.N.Fred	1
KennethP.Smith	HananSamet	1
SteffenStaab	OlgaDeTroyer	1
YuMeng	MargaretH.Dunham	1
LeiYu	HuanLiu	1
ShinichiNakasuka	NaokiIshihama	1
StefanSigg	MarcusDill	1
MahmutT.Kandemir	JayaprakashPisharath	1
ZhenyuLiu	ChangLuo	1
RamdevKanapady	AleksandarLazarevic	1
QiHan	DmitriV.Kalashnikov	1
YihuaLiao	AlejandroPasos	1
WeiWang0009	ChenWang	3
ParvathiChundi	DanielJ.Rosenkrantz	2
GennaroMiele	AngeloCiaramella	1
MegumiIshii	HidekazuNakawatase	1
ZongfangZhou	XiaowoTang	1
JunxiangZhang	ChongfuHuang	1
IsabelF.Cruz	DinaQ.Goldin	1
YavuzGurcan	GokceLaleci	1
MichaelF.Worboys	AnthonyStefanidis	1
ThanaaM.Ghanem	RobertGwadera	1
SvenSchmidt	HenrikeBerthold	1
SathyakamaSandilya	R.BharatRao	1
KhaledYagoub	KarlDias	1
RongJin	LuoSi	1
LucaDeSantis	KarlAberer	1
StijnVansummeren	GottfriedVossen	1
VipulKashyap	MonicaScannapieco	1
Yi-fangBrookWu	RazvanStefanBot	1
HiroyukiKitagawa	AkiraMatsumoto	1
Jen-WeiHuang	Bi-RuDai	1
PeterJ.Haas	IvanPopivanov	1
DimitrisPapadopoulos	DimitriosGunopulos	1
PhilipA.Bernstein	ChristophQuix	1
PatrickE.O'Neil	ElizabethJ.O'Neil	2
RamaswamyHariharan	JehanWickramasuriya	1
MohamedF.Mokbel	KhaledM.Elbassioni	1
Jun-PengBao	Hai-YanLiu	1
JongeunJun	DennisMcLeod	1
TakayoshiShoudai	KenichiTakahashi	1
ShariqRizvi	SaileshKrishnamurthy	1
TsutomuTerada	ShojiroNishio	1
ChristianKleinerman	BeysimSezgin	1
RuiminShen	PengHan	1
SungwonJung	Song-YiYi	1
MegumiIshii	JunjiTomita	1
PaoloCiaccia	MarcoPatella	1
YirongXu	DianaZhou	1
WilliamPerrizo	WeihuaWu	1
HonggangZhang	ChristianKleinerman	1
Chung-WenCho	Chia-HsiungLee	1
RongGe	MartinEster	1
St*phaneGan*arski	RachidGuerraoui	1
TaoLi	ShengMa	3
RodrigoSalvadorMonteiro	LeonardoGuerreiroAzevedo	1
StefanoLonardi	JessicaLin	2
ErichJ.Neuhold	EduardoMena	1
Yi-FengLin	Wen-ChiChou	1
YoungJinJung	Eung-JaeLee	1
JiepingYe	HaesunPark	1
DanLin	BengChinOoi	1
TaoLin	StephanHaller	1
QiankunZhao	MukeshK.Mohania	1
GuyM.Lohman	DavidE.Simmen	2
NicolasSpyratos	GeorgeSamaras	1
EamonnJ.Keogh	Chotirat(Ann)Ratanamahatana	2
YusukeSuzuki	KenichiTakahashi	1
MichaelPatek	JayantKalagnanam	1
SamuelMadden	MichaelF.Worboys	1
WilliamW.Cohen	SunitaSarawagi	1
ZhengChen	EdwardA.Fox	1
MarkoKrema	ChadM.Cumby	1
JohnLangford	ArindamBanerjee	1
ChenyiXia	BengChinOoi	1
YannisPapakonstantinou	AlinDeutsch	2
Ren*eJ.Miller	KennethC.Sevcik	1
LucianVladLita	JaimeG.Carbonell	1
Wen-ChiChou	Tzong-HanTsai	1
ShawnBowers	DavidMaier	1
QiongmaoShen	DimitrisPapadias	1
RobertoJ.BayardoJr.	RalfRantzau	1
MichaelSteinbach	HuiXiong	2
ZhiyongShen	QiangYang	1
SrikanthBellamkonda	AbhinavGupta	1
ZhengChen	Hua-JunZeng	5
MurrayF.Brennan	HyoilHan	1
RaghuRamakrishnan	DeborahS.Gross	1
ShuichengYan	NingLiu	1
Yi-DongShen	Shi-MingZhang	1
Zo*Lacroix	MehdiEssid	1
HermanL.Ferr*	AdamKowalczyk	1
HowardJ.Hamilton	CamiloRostoker	1
WesleyW.Chu	JunghooCho	1
StephenBoyer	RobertCunningham	1
ThomasRisse	ArisM.Ouksel	1
KevinS.Beyer	Fatma*zcan	1
YidaWang	San-YihHwang	1
PhilippePucheral	Fran*oisDangNgoc	1
VanesaLobato	Nicol*sdeAbajo	1
RakeshAgrawal	KrishnaKummamuru	1
ShinichiMurata	MuneakiOhshima	1
Hans-PeterKriegel	ClaudiaPlant	1
PrabhakarRaghavan	MahathiS.Mahabhashyam	1
WeiWang0010	NagaK.Govindaraju	1
ShivnathBabu	KameshMunagala	1
DanielS.Weld	AlonY.Halevy	1
SamLightstone	ChristianGarcia-Arellano	1
NickKoudas	LiangJin	1
KirkScott	DongmeiRen	1
StefanKramer	LotharRichter	1
BaharehNavai	AlbertA.Rizzo	1
VipinKumar	HaesunPark	1
MonicaScannapieco	ErichJ.Neuhold	1
EinarMykletun	BalakrishnaR.Iyer	1
HillolKargupta	HaimontiDutta	1
SeokkyungChung	JongeunJun	1
Fran*oisRioult	ArnaudSoulet	1
ThodorosTopaloglou	MikeTyers	1
MingC.Lin	DineshManocha	1
VasilisVassalos	BhavaniM.Thuraisingham	1
RuggeroG.Pensa	ClaireLeschi	1
RobertMeersman	J.WennyRahayu	1
EduardoMena	ArantzaIllarramendi	2
ShambhuJ.Upadhyaya	JianPei	1
YasuakiNakamura	TomoyukiUchida	1
StephenE.Robertson	HugoZaragoza	1
JunyuCheng	HanhuiHu	1
MichaelJ.Taylor	HugoZaragoza	1
VivekR.Narasayya	SanjayAgrawal	2
MichaelBiwer	MatthiasBender	1
VagelisHristidis	GautamDas	1
JalelBen-Othman	GuyBernard	1
ShlomoZilberstein	AndrewArnt	1
HermanL.Ferr*	BhavaniRaskutti	1
VijayKrishnan	JayantR.Haritsa	1
LaraDeVinco	AngeloCiaramella	1
TengjiaoWang	ShuaiMa	2
TeruakiHomma	KatsuyukiYamazaki	1
TuBaoHo	SiQuangLe	1
Jos*A.Blakeley	AlazelAcheson	1
SamuelMadden	A.Howard	1
RamakrishnanSrikant	DmitriAsonov	1
RahulGupta	NeerajAgrawal	1
JoelE.Richardson	CarolJ.Bult	1
YaboXu	JeffreyXuYu	2
JianYin	BiswajitPanja	1
MohamedY.Eltabakh	MohamedG.Elfeky	1
PrakashLinga	AdinaCrainiceanu	1
SilviaNittel	AlexandrosLabrinidis	1
MauricevanKeulen	JensTeubner	1
TokWangLing	Chuan-HengAng	1
PaulBradley	AlexMitchell	1
NanZhang0002	MartinH.C.Law	1
Wei-YingMa	Gui-RongXue	3
SudhirVerma	JayantKalagnanam	1
StefanManegold	NielsNes	1
JamesS.Schwaber	GregoryE.Gonye	1
MohammadMahdian	AminSaberi	1
TrevorP.Martin	Beng-SeukLee	1
SergeAbiteboul	BogdanCautis	2
XinDong	AlonY.Halevy	3
TaoLiu	LiZhang	1
WilliamI.Grosky	Fr*d*ricAndr*s	1
XiaoleiLi	HwanjoYu	1
YonatanAumann	RonenFeldman	1
VivekR.Narasayya	ManojSyamala	1
WalidG.Aref	JeffreyScottVitter	2
IsabelF.Cruz	AnthonyStefanidis	1
WeiZhao	NanZhang0004	1
PatrickPorter	MosheY.Vardi	1
JulianaFreire	AbhijitKadlag	1
MichaelW.Kattan	JanezDemsar	1
LorettaAuvil	JiaweiHan	1
S.Sudarshan	PrasanRoy	1
MohamedG.Elfeky	AnnChristineCatlin	1
SamuelMadden	DinaQ.Goldin	1
SpirosPapadimitriou	DeepayanChakrabarti	1
MohamedF.Mokbel	IhabF.Ilyas	1
SouripriyaDas	JagannathanSrinivasan	1
B.S.Manjunath	AmbujK.Singh	1
StathesHadjiefthymiades	GeorgeAlyfantis	1
WagnerTruppel	EamonnJ.Keogh	1
JananT.Eppig	CarolJ.Bult	1
WeiguoFan	QianShengCheng	1
YaboXu	GuimeiLiu	1
OlfaNasraoui	MrudulaPavuluri	1
WonminSong	SungwonJung	1
WilliamPerrizo	DongmeiRen	3
MonicaScannapieco	Mohand-SaidHacid	1
Fran*oisJacquenet	ChristineLargeron	1
MonicaScannapieco	H.V.Jagadish	1
LeonidLibkin	AlbertoO.Mendelzon	1
LiZhang	LiMa	1
KevinChen-ChuanChang	BinHe	8
Myung-WonKim	JoungWooRyu	2
SabineMassmann	ErhardRahm	1
Wei-YingMa	NingLiu	1
KongyiZhou	K.Karun	1
SasoDzeroski	HendrikBlockeel	1
MikeLenaghan	GilPress	1
RaymondJ.Mooney	FosterJ.Provost	1
TizianaCatarci	F*lixSaltor	1
PatriciaSerrano-Alvarado	ClaudiaRoncancio	1
RichCaruana	AlexandruNiculescu-Mizil	1
EduardoF.Galvez	AnuragMaskey	1
VipulKashyap	StefanoSpaccapietra	1
Wei-YingMa	JunYan	3
JiepingYe	HuiXiong	1
VipinKumar	JiepingYe	1
NarainH.Gehani	CathyH.Wu	1
KarinKailing	ChristianBaumgartner	1
KennethA.Ross	JingrenZhou	1
WalidG.Aref	MoustafaA.Hammad	2
ZetaoYan	JianpingLi	1
SouravS.Bhowmick	LingChen0002	1
MihoOhsaki	KazuyaOkamoto	1
PatrickZimmer	JensGraupmann	1
Wei-YingMa	BenyuZhang	4
VenkatesanT.Chakaravarthy	JeffreyF.Naughton	1
MiteshPatel	ChengkaiLi	1
JunRao	AdamJ.Storm	1
XiaopengXiong	SusanneE.Hambrusch	1
NathanFolkert	AbhinavGupta	1
StefanoSpaccapietra	EduardoMena	1
RaymondK.Wong	FrankyLam	1
YongYe	KalpathiR.Subramanian	1
DeborahS.Gross	DavidR.Musicant	1
RichUrmston	GilPress	1
AntoninoStaiano	AngeloCiaramella	1
MarioA.Nascimento	ChristianDigout	1
LangLi	JakeYueChen	1
IonStoica	BrentN.Chun	1
YingluoWang	JunTian	1
DimitriosGunopulos	CarlottaDomeniconi	1
ZhenqiangTan	AnthonyK.H.Tung	1
RamakrishnanSrikant	JerryKiernan	3
MohamedY.Eltabakh	MohamedH.Ali	1
RieSawai	MasahikoTsukamoto	1
YutaoShou	NikosMamoulis	1
SaileshKrishnamurthy	EugeneWu0002	1
OmarBenjelloun	ArnaudSahuguet	1
AriD.Brooks	AnnPrestrud	1
YiWu	EdwardY.Chang	1
JeffreyXuYu	GuimeiLiu	1
MichaelJ.Franklin	DavidT.Liu	1
AnilK.Jain	AnaL.N.Fred	1
StratosPaulakis	MichalisVazirgiannis	1
Kun-LungWu	BugraGedik	1
Wen-LianHsu	Wen-ChiChou	1
TonyF.Chan	EdmondHaoCunWu	1
YunghsiangS.Han	ShigangChen	1
JianPei	BaileShi	2
PatrickValduriez	G*r*meCanals	1
Jong-HwaLim	ChulyunKim	1
ToddOlsen	KunLiu	1
WeihuaWu	QiangDing	1
ZhongSu	LiMa	1
ZaiqingNie	SubbaraoKambhampati	1
YuxinChen	MarcoCristo	1
TerriK.Attwood	MelanieHilario	1
Zolt*nGy*ngyi	HectorGarcia-Molina	1
YuqiangGuan	HyukCho	1
ShiminChen	DavidB.Lomet	1
NanZhang0002	AnilK.Jain	1
XiaopengXiong	MohamedG.Elfeky	1
PatrickValduriez	GuyBernard	1
ScottShenker	SamMardanbeigi	1
XiaodongLin	AshishP.Sanil	1
TheodorosEvgeniou	MassimilianoPontil	1
SilviaNittel	SamuelMadden	1
WolfgangLindner	DanielJ.Abadi	1
KunLiu	KakaliSarkar	1
SandraD'Aguanno	GianniCosta	1
SrujanaMerugu	ArindamBanerjee	2
AshishP.Sanil	AlanF.Karr	1
WensiXi	Hua-JunZeng	3
GeorgeA.Mihaila	BhavaniM.Thuraisingham	1
LudgerFiege	JussiKangasharju	1
RuiYang	AnthonyK.H.Tung	1
HowardJ.Hamilton	HongYao	1
JinFan	JieShen	1
NaokiIshihama	KoichiHori	1
TjarkWahnfried	StefanPfennigschmidt	1
MinosN.Garofalakis	CheeYongChan	1
SteffenStaab	ArisM.Ouksel	1
SamMardanbeigi	JosephM.Hellerstein	1
ToniUrp*	DavidGa**n	1
TimothyRoscoe	ShawnR.Jeffery	1
RaymondChi-WingWong	AdaWai-CheeFu	1
MinoruKanehisa	AtsukoYamaguchi	1
SureshVenkatasubramanian	ShankarKrishnan	1
RakeshAgrawal	RaghuRamakrishnan	1
YounghwanLim	Joon-SungYoon	1
MichaelStonebraker	DavidMaier	1
YunChi	YiXia	1
YimingMa	JehanWickramasuriya	1
Wen-ChiChou	Ting-YiSung	1
SherifSakr	JensTeubner	1
JoyceY.Chai	FengKang	1
ShengliSheng	HarryZhang	1
YasushiSakurai	ShunsukeUemura	1
ZhengChen	Gui-RongXue	3
TizianaCatarci	ArisM.Ouksel	1
PaulMason	KenCosh	1
JulianaFreire	JayantR.Haritsa	1
StefanoSpaccapietra	ArisM.Ouksel	1
KiyokoF.Aoki	AtsukoYamaguchi	1
FaridParvini	AlbertA.Rizzo	1
RolandBillen	EliseoClementini	1
MorganC.Wang	DavidS.Vogel	3
VasilisVassalos	MarcoMesiti	1
VipulKashyap	KarlAberer	1
UtkarshSrivastava	PrasannaGanesan	1
Zhi-HuaZhou	GangLi	2
SungwonJung	SooyongPark	1
ThanaaM.Ghanem	IhabF.Ilyas	1
DavidJensen	BrianGallagher	1
KakaliSarkar	HillolKargupta	1
MarcusFontoura	BeverlyYang	1
NigelWestbury	IstvanCseri	1
ShawnR.Jeffery	RyanHuebsch	1
ThomasL.Griffiths	MarkSteyvers	1
YunChi	HaixunWang	1
RongJin	JoyceY.Chai	1
RodrigoSalvadorMonteiro	JanoMoreiradeSouza	1
NatasaMilic-Frayling	HansChalupsky	1
EmaNemes	AlonY.Halevy	1
GokceLaleci	AsumanDogac	1
BinLiu	AmarnathGupta	1
ZhengChen	JunYan	3
TomaszF.Stepinski	Murali-KrishnaAchari	1
V.PrasadChakka	JigneshM.Patel	1
ZehuaLiu	WeeKeongNg	1
ManojSyamala	ArunprasadP.Marathe	1
TheodoreDalamagas	JaroslavPokorn*	1
WilliamH.Piel	NarainH.Gehani	1
StefanoStefani	C*sarA.Galindo-Legaria	1
Jos*A.Blakeley	HonggangZhang	1
ErichJ.Neuhold	ArantzaIllarramendi	1
NingZhong	ChunnianLiu	1
MarcoP*tke	Hans-PeterKriegel	2
JianpingZhang	EricBloedorn	1
SrinivasanParthasarathy	KeithMarsolo	2
SrikanthBellamkonda	LeiSheng	1
PegHowland	HaesunPark	1
VasilisVassalos	GeorgeA.Mihaila	1
HeliHiisil*	EllaBingham	1
PierreGeurts	IbtissamElKhayat	1
JeffreyXuYu	HaifengJiang	1
YongYu	Hua-JunZeng	3
JimMelton	Jan-EikeMichels	1
RonEguchi	CharlesHuyck	1
MichaelW.Berry	FarialShahnaz	1
MinglongShao	GregoryR.Ganger	1
YannisTheodoridis	IlariaBartolini	1
VukErcegovac	DavidJ.DeWitt	1
TakahiraYamaguchi	KazuyaOkamoto	1
JunYan	FengshanBai	1
JiongYang	GaoCong	1
OzgurD.Sahin	DivyakantAgrawal	1
TokWangLing	JiZhang	1
YukWahWong	JayantKalagnanam	1
GiovanniConforti	CarloSartiani	1
RameshJain	BinWu	1
SeogPark	ChanjungPark	1
RalfRantzau	JerryKiernan	1
TakashiWashio	HiroshiMotoda	2
XuanhuiWang	Wei-YingMa	1
ThanaaM.Ghanem	MiretteS.Marzouk	1
MartinPfeifle	EshrefJanuzaj	2
JiaweiHan	AndrewY.Wu	1
VolkerMarkl	IvanPopivanov	1
YousukeWatanabe	HiroyukiKitagawa	1
ThomasSeidl	StefanSch*nauer	2
SouravS.Bhowmick	SanjayKumarMadria	1
SangKyunCha	ChangbinSong	1
XuezhongZhou	JunliChen	1
MorHarchol-Balter	DavidT.McWherter	1
MohammedJaveedZaki	KarltonSequeira	1
FaroukToumani	AgnieszkaRutkowska	1
YimingZeng	WenfeiFan	1
YannisVelegrakis	LucianPopa	1
Hua-JunZeng	Chun-YiShi	1
ShawnR.Jeffery	AnilEdakkunni	1
SunitaSarawagi	AlokKirpal	1
MaurizioMazza	BarbaraCatania	1
RobertoJ.BayardoJr.	RamakrishnanSrikant	1
Yi-anHuang	PhilipS.Yu	2
IoanaManolescu	AndreaPugliese	1
LingQin	JinFan	1
KevinKeenoy	GeorgeLoizou	1
BhavaniRaskutti	AdamKowalczyk	2
ShojiroNishio	RieSawai	1
RahulShah	JeffreyScottVitter	3
MoninderSingh	JayantKalagnanam	1
ThomasHofmann	LijuanCai	1
JohnShepherd	DuQ.Huynh	1
PaulB.Kantor	DmitriyFradkin	1
SteffenStaab	Mohand-SaidHacid	1
VipulKashyap	OlgaDeTroyer	1
TizianaCatarci	StefanoSpaccapietra	1
StefanSiersdorfer	GerhardWeikum	1
YannisDrougas	ManolisKoubarakis	1
MariosHadjieleftheriou	GeorgeKollios	1
VijayshankarRaman	AshrafAboulnaga	1
WeiyiMeng	AnHaiDoan	1
FilippoMenczer	DavidB.Leake	1
GeorgLausen	Cai-NicolasZiegler	1
RameshJain	BinLiu	1
M.ElenaRenda	JamieCallan	1
RajeevRastogi	AbhinandanDas	1
NiinaHaiminen	AristidesGionis	1
Jan-MingHo	Hung-YuKao	2
P*velCalado	MarcoCristo	1
ZhihuaWang	YunyueZhu	1
RobertHayward	JiaLi	1
PanagiotisG.Ipeirotis	LuisGravano	1
LinDeng	DikLunLee	2
SaileshKrishnamurthy	JosephM.Hellerstein	1
MichaelJ.Franklin	DavidJ.DeWitt	1
TomazCurk	GregorLeban	1
IoanaManolescu	BertramLud*scher	1
MichaelYuZhu	LeiLiu	1
TimothyRoscoe	ScottShenker	1
KrishnaG.Kulkarni	JimMelton	1
ThanaaM.Ghanem	MoustafaA.Hammad	1
QiangJing	AnthonyK.H.Tung	1
MarkoGrobelnik	DunjaMladenic	1
JunYan	HuaLi	1
RemaPadman	EdoardoAiroldi	1
Jian-TaoSun	Hua-JunZeng	1
NaokoKosugi	MasashiMorimoto	1
YishengDong	WenpingSu	1
Ya-HuiChang	Hsiao-FeiLiu	1
OlivierSaidi	LianYan	1
KemalAltintas	AmnonMeyers	1
RaymondK.Wong	DamienK.Fisher	1
MayaRamanath	LingzhiZhang	1
RichardHull	DanielF.Lieuwen	1
StefanBrandl	ChristianWiesner	1
RichardHull	IriniFundulaki	1
DenilsonBarbosa	AlbertoO.Mendelzon	1
FarnoushBanaeiKashani	CyrusShahabi	1
XiaoweiJiang	EbruErsan	1
PeerKr*ger	ClaudiaPlant	1
M.DoloresdelCastillo	JoseIgnacioSerrano	1
YongYu	Gui-RongXue	3
Yu-ChiangLi	Shin-MuTseng	1
St*phaneLopes	FabienDeMarchi	1
Y.DoraCai	DavidClutter	1
ToddC.Mowry	PhillipB.Gibbons	1
SelimAksoy	KrzysztofKoperski	1
ElisaBertino	BarbaraCatania	2
XiaojunChen	GangKou	1
YannisPapakonstantinou	IoanaManolescu	1
SergejSizov	GerhardWeikum	1
ShalendraChhabra	FidelisAssis	1
StefanieScherzinger	ChristophKoch	2
ZhengHuang	LeiChen0003	2
YunyueZhu	XiaojianZhao	1
MinosN.Garofalakis	MingXiong	1
PascalMolli	G*r*meCanals	1
GerhardWeikum	AnastassiaAilamaki	1
RichardTibbetts	DavidMaier	1
JamesA.Kadin	CarolJ.Bult	1
KarimBa*na	BryanHarianto	1
UmaMahadevan	RaviKumar	1
MichaelEgmont-Petersen	ArnoSiebes	1
JagannathanSrinivasan	GeorgeEadon	1
MarcoMesiti	BarbaraCatania	1
GrahamCormode	DiveshSrivastava	2
WilfredNg	JamesCheng	1
Y.DoraCai	MichaelWelge	1
StefanManegold	PeterA.Boncz	1
KotagiriRamamohanarao	HamadAlhammady	2
MinosN.Garofalakis	AlinDobra	1
WojciechSzpankowski	RobertGwadera	1
Ji-RongWen	HaifengLiu	1
ThomasRisse	Mohand-SaidHacid	1
WensiXi	BenyuZhang	1
ToshiyukiAmagasa	ShunsukeUemura	1
InderjitS.Dhillon	BrianKulis	1
XiaojianZhao	AlbertoLerner	1
JeffreyXuYu	AoyingZhou	1
Yi-FengLin	Kuen-PinWu	1
SamYuanSung	PeterA.Ng	2
LiseGetoor	AndreasHotho	1
OmerZaafrany	MenahemFriedman	1
XiangJi	Chao-HsienChu	1
YvesPetinot	IsaacG.Councill	1
RalfDuckstein	KlemensB*hm	1
SamuelMadden	AlexandrosLabrinidis	1
KevinHarris	JanetWebster	1
MirekRiedewald	AbhinandanDas	1
Yi-ChengTu	RaduSion	1
NikosMamoulis	GeorgeKollios	1
GeorgeLoizou	AlexandraPoulovassilis	1
PatrickZimmer	MartinTheobald	1
GangLi	DanWei	1
DmitryLenkov	AravindYalamanchi	1
Hans-PeterKriegel	ChristianBaumgartner	1
JianpingZhang	DanielVenese	1
RaghuRamakrishnan	JamesJ.Schauer	1
Hans-ArnoJacobsen	HaifengLiu	2
WilliamS.Yerazunis	FidelisAssis	1
MichailVlachos	ChristopherMeek	1
SamuelBushra	HillolKargupta	1
NaliniVenkatasubramanian	AmnonMeyers	1
JanO.Pedersen	HectorGarcia-Molina	1
SamuelMadden	CarlosGuestrin	1
PatrickBlair	HillolKargupta	1
ZidongWang	PaulO'Neill	1
PeterBuneman	ByronChoi	1
MaxJ.Egenhofer	A.Howard	1
VojkanMihajlovic	DjoerdHiemstra	1
KarlStrohmaier	JinzeLiu	1
Y.DoraCai	LorettaAuvil	1
FengshanBai	BenyuZhang	1
CiroDonalek	AntoninoStaiano	1
SophieChabridon	RachidGuerraoui	1
LanceParsons	HuanLiu	1
PhilippePucheral	BrunoDefude	1
SanjayKumarMadria	BiswajitPanja	1
DingZhou	BaileShi	1
MirekRiedewald	JohannesGehrke	1
RichardHull	ArnaudSahuguet	1
ZhengChen	FengshanBai	1
TaoTao	BinHe	2
YoheiIkawa	KunihikoSadakane	1
ClaudiaPlant	ChristianBaumgartner	1
Gui-RongXue	DouShen	1
StefanoRizzi	AnnaMaddalena	1
YufeiTao	XiangLian	1
PhillipB.Gibbons	AnastassiaAilamaki	1
Wai-ShingHo	ChiLapYip	1
VassilisChristophides	GiorgosKokkinidis	2
TakahiraYamaguchi	HidetoYokoi	1
MichaelJ.Franklin	EugeneWu0002	1
PatrickValduriez	PascalMolli	1
TimothyW.Finin	AnupamJoshi	1
RanieriBaraglia	FabrizioSilvestri	1
SunilPrabhakar	MikhailJ.Atallah	2
XiaoyongChai	LinDeng	2
MichaelJ.Franklin	FrederickReiss	1
FuchunPeng	AoFeng	1
YvesPetinot	HuiHan	1
H.V.Jagadish	FrankOlken	1
ZhimingDing	RalfHartmutG*ting	1
MichaelBiwer	ChristianZimmer	1
EliyahuSafra	CatrielBeeri	1
WynneHsu	LiangHuaiYang	3
RobertNichol	BrighamAnderson	1
VipinKumar	JinSoungYoo	1
MarcAnderson	ChristopherBesemann	1
MohammadMahdian	JenniferT.Chayes	1
WeiHong	OwenCooper	1
DonaldKossmann	DanielaFlorescu	1
SenZhang	DennisShasha	1
PedroDomingos	DeepakVerma	1
TomaszF.Stepinski	RicardoVilalta	1
AndrewW.Moore	AndrewConnolly	1
ZacharyG.Ives	AlonY.Halevy	2
DanLin	BoHuang	1
StefanoSpaccapietra	F*lixSaltor	1
MasafumiHamamoto	Jia-YuPan	1
PhilippeCudr*-Mauroux	ArantzaIllarramendi	1
WeiHong	ShariqRizvi	1
XiaoleiLi	JiaweiHan	2
TingYu	NickKoudas	1
JamesChilson	AlanWagner	1
SridharRamachandran	SanjayE.Sarma	1
ToniUrp*	CarlosBeltr*n	1
ChristophKoch	BernhardStegmaier	2
MichaelRabinovich	DiveshSrivastava	1
LeonidLibkin	LaurentMignet	1
ZhenyuLiu	WesleyW.Chu	1
WendyHuiWang	LaksV.S.Lakshmanan	1
SharadMehrotra	EinarMykletun	1
StephanBloehdorn	AndreasHotho	2
IgorNaiFovino	ElisaBertino	1
SiyamedS.Sinir	AsumanDogac	1
DimitrisPapadias	BinLiu0002	2
DanielBarbar*	CarlottaDomeniconi	1
SanjayChawla	PeiSun	1
NarainH.Gehani	JasonTsong-LiWang	1
RogerMacNicol	BlaineFrench	1
TolgaBozkaya	LeiSheng	1
TerriK.Attwood	Jee-HyubKim	1
M.Tamer*zsu	LeiChen0002	1
GeorgeT.Heineman	ElkeA.Rundensteiner	2
KuiyangLou	KarthikRamani	1
GeorgiosEvangelidis	DimitriosDervos	1
MarkLast	AbrahamKandel	1
KouzouOhara	HiroshiMotoda	1
LingLiu	BugraGedik	2
WenJin	MartinEster	2
HectorGarcia-Molina	AristidesGionis	1
NarenRamakrishnan	DeeptKumar	1
MassimoMecella	ArisM.Ouksel	1
ZhenyuanWang	Hai-FengGuo	1
SungrimKim	JoonheeKwon	1
TuBaoHo	HuiZhang	1
FengTian	BertholdReinwald	1
EdwardY.Chang	AnkurJain	1
LiangyouChen	HasanM.Jamil	1
KaidiZhao	BingLiu	1
YangSong	SouravS.Bhowmick	1
ThomasR.Lynam	ChrisBuckley	1
Mong-LiLee	JunmeiWang	1
YuqingWu	LaksV.S.Lakshmanan	1
Jin-yiCai	DavidR.Musicant	1
RamanathanV.Guha	AndrewTomkins	1
ThomasR.Lynam	CharlesL.A.Clarke	1
RobertoTagliaferri	GennaroMiele	1
VanesaLobato	SergioR.Cuesta	1
NicolaOnose	MaryF.Fern*ndez	1
SiyamedS.Sinir	AliYildiz	1
NickCercone	BinTang	1
GiriKumarTayi	AshwinSatyanarayana	1
GerhardWeikum	AnjaTheobald	1
SteffenStaab	ArantzaIllarramendi	1
WikilKwak	HeeseokLee	1
SasoDzeroski	MarkoDebeljak	1
SamerNassar	CorrineCheng	1
RonaldoC.Prati	MariaCarolinaMonard	1
TingChen	DaofengLuo	1
YongShi	JianpingLi	1
Hye-YoungPaik	AgnieszkaRutkowska	1
MinosN.Garofalakis	AbhinandanDas	1
ReneQuiniou	Marie-OdileCordier	1
EgidioTerra	CharlesL.A.Clarke	1
DimitriosGunopulos	ChristopherMeek	1
HiroshiMotoda	AkihiroNakashima	1
TetsuhiroMiyahara	TakayoshiShoudai	1
SugatoBasu	RaymondJ.Mooney	2
SerkanKirbas	GokceLaleci	1
JieChi	AnanthGrama	1
ZhenZhang	BinHe	4
XiaohuaHu	HyoilHan	1
XiaoshuHang	HonghuaDai	1
SudarshanMurthy	DavidMaier	1
KalervoJ*rvelin	JormaLaurikkala	1
WenyuanLi	WeeKeongNg	3
TakahiroHara	ShojiroNishio	1
XinyuGuo	LiangHuaiYang	1
RogerS.Barga	DavidB.Lomet	1
MelanieHilario	AlexMitchell	1
YaliZhu	TimothyM.Sutherland	1
PhilippePucheral	LucBouganim	2
NaliniVenkatasubramanian	CarterButts	1
ShouyangWang	LeanYu	2
Ren*eJ.Miller	PeriklisAndritsos	3
StefanoSpaccapietra	MassimoMecella	1
UtkarshSrivastava	GautamDas	1
MinoruKanehisa	KiyokoF.Aoki	1
RaymondT.Ng	H.V.Jagadish	1
RonenFeldman	BinyaminRosenfeld	1
YongShi	JohnJ.Cheh	1
San-YihHwang	JamshidA.Vayghan	1
MichaelJ.Franklin	GarrettJacobson	1
CarlosGuestrin	AmolDeshpande	1
SanjayKumarMadria	MalikAyedTubaishat	1
NathalieJapkowicz	AleksanderKotcz	1
MichaelStonebraker	ArvindArasu	1
RajeevRastogi	AlinDobra	1
PaulO'Neill	KarlFraser	1
GangWu	EdwardY.Chang	1
GabrielM.Kuper	AndreiLopatenko	2
ShuaiChengLi	AnthonyK.H.Tung	1
JehanWickramasuriya	DmitriV.Kalashnikov	1
JohnLangford	BiancaZadrozny	1
OrianeMatte-Tailliez	AhmedAmrani	1
ZhenZhang	MiteshPatel	1
YingGuangLi	AnnaMaddalena	1
KeithMarsolo	HuiYang	1
KotagiriRamamohanarao	JinyanLi	1
Wei-GuangTeng	Ming-SyanChen	1
MayurDatar	BrianBabcock	1
ThemistoklisPalpanas	MichailVlachos	1
DanielA.Keim	BenjaminBustos	1
BeysimSezgin	BalajiRathakrishnan	1
YirongXu	AmeetKini	1
Ming-SyanChen	Jen-WeiHuang	1
NingZhong	MuneakiOhshima	2
SudiptoGuha	DiveshSrivastava	1
RajeevMotwani	NinaMishra	1
DmitriV.Kalashnikov	CharlesHuyck	1
KateA.Smith	DavidTaniar	1
SaileshKrishnamurthy	GarrettJacobson	1
QiangJing	PanosKalnis	1
SouravS.Bhowmick	MukeshK.Mohania	1
SandeepTata	JigneshM.Patel	1
JimengSun	DimitrisPapadias	1
RobertL.Grossman	ChetanGupta	1
JanezDemsar	GregorLeban	1
WalidG.Aref	RobertGwadera	1
SamSkrivan	JonathanTang	1
ZhiyongShen	Shi-MingZhang	1
XueminLin	JeffreyXuYu	1
FaroukToumani	BryanHarianto	1
NatalyaFridmanNoy	AlonY.Halevy	2
WenfeiFan	ArekKasprzyk	1
RuiCamacho	EugenioOliveira	1
G*r*meCanals	BrunoDefude	1
VipulKashyap	ArisM.Ouksel	1
JanoMoreiradeSouza	GeraldoZimbrao	2
YufeiTao	DimitrisPapadias	6
QiangYang	NingLiu	1
NikosMamoulis	HuipingCao	2
Yi-HungWu	Chia-HsiungLee	1
SvenHelmer	GuidoMoerkotte	2
TengjiaoWang	ShiweiTang	3
MarianneWinslett	ArnonRosenthal	2
MichalisVazirgiannis	CharalamposLampos	1
MehmetKoyut*rk	JieChi	1
SamLightstone	PeterJ.Haas	1
JeffreyConsidine	DimitrisPapadias	1
JunYang0001	IoanaStanoi	1
YimingMa	RonEguchi	1
RudolfKruse	ChristianBorgelt	1
MarcCardle	EamonnJ.Keogh	1
JeffreyScottVitter	IhabF.Ilyas	1
MohamedH.Ali	MiretteS.Marzouk	1
StefanoRizzi	ElisaBertino	1
ToshiyukiAmagasa	TakeharuEda	1
RongPan	R.ScottCost	1
MichaelGarland	AndrewY.Wu	1
TengjiaoWang	ChanjunYang	1
PeterKunath	Hans-PeterKriegel	1
Kun-MaoChao	Hsiao-FeiLiu	1
H.V.Jagadish	CongYu	1
ShawnR.Jeffery	BoonThauLoo	1
AndreiArion	AndreaPugliese	1
XiaoweiJiang	JunFang	1
ChristosFaloutsos	AndrewTomkins	1
StephenChi-faiChan	GaryHoiKitLam	1
ElisaBertino	ElenaFerrari	1
TomZylkin	JamesS.Schwaber	1
RiccardoOrtale	AndreaTagarelli	1
T.Hirsim*ki	AtaKab*n	1
ShaulDar	EdenShochat	1
GuyM.Lohman	AdamJ.Storm	1
JunfaLiu	ChunliWang	1
TheodoreDalamagas	TaoCheng	1
MasumSerazi	ImadRahal	1
YunPeng	TimothyW.Finin	1
SamSkrivan	AdamYeh	1
ManuelBarrenaGarc*a	DavidB.Lomet	1
ReynoldCheng	JeffreyScottVitter	1
GiuseppeManco	AndreaTagarelli	1
JanuszR.Getta	EhsanVossough	1
MichaelGertz	M.Tamer*zsu	1
DenisLalanne	DalilaMekhaldi	1
GordonV.Cormack	ChrisBuckley	1
WeiHong	MichaelJ.Franklin	1
OmarBoucelma	MehdiEssid	1
Jan-MingHo	I-AneHuang	1
ScottRenner	LeonardJ.Seligman	1
ZhenZhang	ChengkaiLi	1
Mi-JeongKim	Byoung-WooOh	1
ZacharyG.Ives	AnastassiaAilamaki	1
XiaoqiangWang	QiangDu	1
VolkerMarkl	SamLightstone	1
ZacharyG.Ives	DavidJ.DeWitt	1
XingquanZhu	XindongWu	3
W.BruceCroft	StephenCronen-Townsend	1
PietroMazzoleni	ElenaFerrari	1
XiaohuiLiu	PaulO'Neill	1
MiZhou	HongqiangLi	1
VictorB.Zordan	DimitriosGunopulos	1
MarcoDario	IoanaManolescu	1
MosheY.Vardi	BenjaminJ.McMahan	1
XueminLin	HongjunLu	1
KrishnaramKenthapadi	DilysThomas	1
ChristianB*hm	ArthurZimek	1
PengHan	FanYang	1
MassimoMecella	KarlAberer	1
VenkatesanT.Chakaravarthy	RaghavKaushik	1
VivekBhatnagar	IsaacG.Councill	1
PingChen	DanielBarbar*	1
NigelWestbury	ElizabethJ.O'Neil	1
JohnR.Smith	ApostolNatsev	1
Jun-YiShen	Jun-PengBao	1
RobertGwadera	MoustafaA.Hammad	1
RuomingJin	GaganAgrawal	1
PinarDuygulu	ChristosFaloutsos	1
JeromeP.Reiter	AshishP.Sanil	1
ZhenHe	ByungSukLee	1
GiovanniA.Modica	AvigdorGal	1
CyrusShahabi	BaharehNavai	1
PrakashLinga	AshwinMachanavajjhala	1
XingboYu	WeiwenYang	1
StevenMinton	CraigA.Knoblock	1
WalidG.Aref	MohamedG.Elfeky	2
ShusakuTsumoto	ShojiHirano	1
SharadMehrotra	NaliniVenkatasubramanian	2
EricLo	BenKao	1
Mohand-SaidHacid	BoualemBenatallah	1
MohamedG.Elfeky	AhmedK.Elmagarmid	2
MariOstendorf	ConstantinosBoulis	1
RamakrishnanSrikant	RalfRantzau	1
StefanoStefani	FlorianWaas	1
ZhengHuang	DavidR.Musicant	1
MarkdeBerg	HermanJ.Haverkort	1
RamachandranVenkatesh	GideonSchaller	1
ThomasRisse	LucaDeSantis	1
MichelangeloCeci	AnnalisaAppice	1
MiteshPatel	KevinChen-ChuanChang	1
MuralidharKrishnaprasad	JamesW.Warner	1
SouravChakraborty	PhilipS.Yu	1
VanesaLobato	AlbertoB.Diez	1
MichaelPowers	DavidHandy	1
LoredanaParasilitiProvenza	IgorNaiFovino	1
RobertSchroko	ChidanandApt*	1
TomoyukiUchida	KenichiTakahashi	1
JohnF.Roddick	ErikG.Hoel	1
F*lixSaltor	EduardoMena	1
YufeiTao	MariosHadjieleftheriou	1
ChristianGarcia-Arellano	AdamJ.Storm	1
HiroyukiKitagawa	AtsuyukiMorishima	1
WitoldLitwin	RimMoussa	1
SoumenChakrabarti	AbhayHarpale	2
LeandroNunesdeCastro	EduardoR.Hruschka	1
PaoloMerialdo	GiansalvatoreMecca	1
XiaoleiLi	DuaneSearsmith	1
RonEguchi	JehanWickramasuriya	1
ThibautLamadon	HenrySoldano	1
XiaopengXiong	MoustafaA.Hammad	2
HamidPirahesh	CalistoZuzarte	1
SubodhKumar	JatinChhugani	1
KevinChen-ChuanChang	ChengkaiLi	1
SunilPrabhakar	ReynoldCheng	1
YavuzGurcan	SiyamedS.Sinir	1
YunChi	YirongYang	1
AmyWang	AmeetKini	1
Ming-SyanChen	Kun-TaChuang	1
TingYu	MichaelRabinovich	1
TorstenSuel	DimitreTrendafilov	1
IosifLazaridis	DmitriV.Kalashnikov	1
Kuo-ZuiLin	Chia-HuiChang	1
LoredanaParasilitiProvenza	ElisaBertino	1
ScottFadden	ChristianGarcia-Arellano	1
YannisE.Ioannidis	MinosN.Garofalakis	2
MarkusKeidl	AlfonsKemper	1
StefanPfennigschmidt	Agn*sVoisard	1
BrunoApolloni	AndreaBrega	1
ZhaohuiZheng	RohiniK.Srihari	1
YimingMa	CarterButts	1
ErichJ.Neuhold	ArisM.Ouksel	1
MarkShavlik	JudeW.Shavlik	1
YongtaiZhu	ChenWang	1
NishantMehta	BradfordPielech	1
RolfA.deBy	NirvanaMeratnia	1
LiyuLi	DongqingYang	1
BryanHarianto	AgnieszkaRutkowska	1
RobertoZanoli	AlbertoLavelli	1
GennaroMiele	CiroDonalek	1
UlrichMeissen	Agn*sVoisard	1
JohnF.Roddick	BettySalzberg	1
MasaruKitsuregawa	BotaoWang	1
MehdiEssid	AbdelkaderB*tari	1
RudiStuder	ArantzaIllarramendi	1
MehmetEminD*nderler	EdizSaykol	1
ShanzhongZhu	ChinyaV.Ravishankar	1
IriniFundulaki	DanielF.Lieuwen	1
ChengXiangZhai	AtulyaVelivelli	1
QiangWang	GuoLi	1
JeffreyP.Lankford	EamonnJ.Keogh	2
MenahemFriedman	BrachaShapira	1
JianliangXu	BaihuaZheng	2
ThanaaM.Ghanem	AnnChristineCatlin	1
MatthiasSchubert	Hans-PeterKriegel	3
LouiqaRaschid	HymaMurthy	1
HyoilHan	AnnPrestrud	1
RonHutchison	AjayYekkirala	1
XiaoweiJiang	MasonBendixen	1
JeanFerri*	GuyBernard	1
SridharRajagopalan	KevinS.Beyer	1
VincentC.S.Lee	DammindaAlahakoon	1
MarkdeBerg	KeYi	1
PatrickZimmer	ChristianZimmer	1
KevinHarris	JonathanL.Herlocker	1
PaatRusmevichientong	DavidSelinger	1
ShinyaKitaguchi	MihoOhsaki	1
SiyamedS.Sinir	SerkanKirbas	1
CharlesHuyck	AmnonMeyers	1
TimChurches	MarkusHegland	1
ZhihengLi	YaboXu	1
JayantR.Haritsa	A.Kumaran	4
Wei-YingMa	HaifengLiu	1
XiaopengXiong	IhabF.Ilyas	1
Jae-ChulSir	DongyeopRyu	1
DavidRosenbluth	Chung-MinChen	1
YorkSure	LiseGetoor	1
ErnestTeniente	DavidGa**n	1
TorstenGrust	MauricevanKeulen	1
MarcAnderson	AjayYekkirala	1
ThomasZurek	MarcusDill	1
XinXu	BengChinOoi	1
YiChen	SusanB.Davidson	2
MarkLast	BrachaShapira	1
VipulKashyap	PhilippeCudr*-Mauroux	1
MonicaScannapieco	ArantzaIllarramendi	1
YuniXia	ReynoldCheng	1
JunFang	BalajiRathakrishnan	1
GaoCong	BengChinOoi	2
ShawnR.Jeffery	IonStoica	1
Mong-LiLee	LiangHuaiYang	3
MartinLeucker	BenediktBollig	1
YongtaiZhu	WeiWang0009	1
SachindraJoshi	RahulGupta	1
GuyM.Lohman	Beno*tDageville	1
TjarkWahnfried	Agn*sVoisard	1
XuanhuiWang	DouShen	1
JalelBen-Othman	BrunoDefude	1
YoungdukSeo	BongheeHong	1
KevinGoslar	AlexanderSchill	1
VanjaJosifovski	AlanHalverson	1
RaymondJ.Mooney	PremMelville	1
NickKoudas	DiveshSrivastava	3
JenniferWidom	GlenJeh	1
ShichaoZhang	LiLiu	1
YonghuaWu	GeneTsudik	1
StefanoCeri	SaraComai	1
FaizCurrim	CurtisE.Dyreson	1
RamasamyUthurusamy	K.P.Unnikrishnan	1
Mohand-SaidHacid	LucaDeSantis	1
StavrosHarizopoulos	AnastassiaAilamaki	1
WeeSunLee	HaoranWu	1
HalvardSkogsrud	FabioCasati	1
SamerNassar	J*rgSander	1
SumitK.Sanghai	NileshN.Dalvi	1
TolgaBozkaya	AndrewWitkowski	1
SimeonJ.Simoff	DavidB.Skillicorn	1
XiaoliLi	SreeramRamachandaran	1
SharadMehrotra	QiZhong	1
BalajiRathakrishnan	AlazelAcheson	1
YounghwanLim	Jae-ChulSir	1
QinLv	MosesCharikar	1
StijnVansummeren	JanVandenBussche	1
ShinichiMurata	NingZhong	1
SuvritSra	HyukCho	1
PhilipA.Bernstein	JenniferWidom	1
IanDavidson	GoutamPaul	1
RakeshAgrawal	JerryKiernan	3
Marie-ChristineRousset	AlexandreTermier	1
JenniferWidom	AlonY.Halevy	1
SamuelBushra	KakaliSarkar	1
RudiStuder	ArisM.Ouksel	1
RobertSchroko	NavalK.Verma	1
SooyongPark	Song-YiYi	1
Zo*Lacroix	AbdelkaderB*tari	1
EdwardA.Fox	BaopingZhang	1
RajeshNatarajan	B.Shekar	1
ZacharyG.Ives	IoanaManolescu	1
JunFang	GideonSchaller	1
RudiStuder	KarlAberer	1
MarkScardina	JinyuWang	1
GarethJ.Janacek	AnthonyJ.Bagnall	1
PaulJ.Kennedy	DanielR.Catchpoole	1
MakotoSano	DavidA.Evans	1
DavidLiben-Nowell	AndrewTomkins	1
JalelBen-Othman	ClaudiaRoncancio	1
NagenderBandi	ChengyuSun	1
SophieChabridon	PatrickValduriez	1
MotiSchneider	MarkLast	1
SergeyMelnik	MichalisPetropoulos	1
EstherRyvkina	AnuragMaskey	1
YehoshuaSagiv	CatrielBeeri	1
Kwang-BaekKim	IlKonKim	1
ShariqRizvi	FrederickReiss	1
ArijitMukherjee	AlvaroA.A.Fernandes	1
MartinKlein	HillolKargupta	1
RicardoVilalta	ChristophF.Eick	1
ZhengdengLei	YangDai	1
YimingZeng	CheeYongChan	1
DanielF.Lieuwen	BharatKumar	1
KarlDias	Beno*tDageville	1
JianliangXu	DikLunLee	1
MarcusFontoura	KevinS.Beyer	1
KenichiYoshida	KatsuyukiYamazaki	1
SandeepMane	San-YihHwang	1
YusukeSuzuki	TetsuhiroMiyahara	1
RobinMcEntire	DanieleTuri	1
RichardTibbetts	MitchCherniack	1
TolgaBozkaya	NathanFolkert	1
Wen-LianHsu	Tzong-HanTsai	1
SiminHe	ShiguangShan	1
SumitK.Sanghai	PedroDomingos	1
St*phaneLopes	Jean-MarcPetit	1
PradeepB.Teregowda	IsaacG.Councill	1
LingLiu	JamesCaverlee	1
ThomasRisse	ArantzaIllarramendi	1
WenGao	ShiguangShan	1
ManuelBarrenaGarc*a	LinanJiang	1
ZhengxinChen	YiPeng	1
RamjiBeera	RamanathanBalachandran	1
Ding-YingChiu	ArbeeL.P.Chen	1
SugatoBasu	ArindamBanerjee	1
YasushiSakurai	NaokoKosugi	1
WeiWang0010	JiongYang	3
Yi-DongShen	QiangYang	1
MiteshVasa	DavidHandy	1
SharadMehrotra	AmnonMeyers	1
StefanBrecheisen	MartinPfeifle	3
ZhiyongHuang	HuaLu	1
SamuelMadden	J*rgSchuler	1
GautamDas	DimitriosGunopulos	1
KatharinaMorik	HannaK*pcke	1
TovaMilo	ArnaudSahuguet	1
YingXu0002	NinaMishra	1
Mohand-SaidHacid	ErichJ.Neuhold	1
ThomasL.Griffiths	PadhraicSmyth	1
SusanneE.Hambrusch	SunilPrabhakar	1
StephenJ.Wright	LeiChen0003	1
OwenCooper	AnilEdakkunni	1
YanChen	SouravS.Bhowmick	1
DinaQ.Goldin	A.Howard	1
NavalK.Verma	ChidanandApt*	1
RuchitaBhargava	HillolKargupta	1
CyrusShahabi	AlbertA.Rizzo	1
Zheng(Jessica)Zhao	GaneshRamesh	1
StefanoLonardi	EamonnJ.Keogh	3
WeiWang0010	JanPrins	1
YuvalElovici	MenahemFriedman	1
VivekBhatnagar	C.LeeGiles	1
JamesE.Grover	ChristopheG.Lambert	1
ShantanuGodbole	AbhayHarpale	2
VanessaP.Braganholo	SusanB.Davidson	1
RamanathanV.Guha	DanielGruhl	1
SandeepKhanzode	RuofeiZhang	1
YanHuang	HuiXiong	1
ShiweiTang	LiyuLi	1
GersonZaverucha	Alo*sioCarlosdePina	1
SamuelMadden	JosephM.Hellerstein	1
WeiguoFan	BenyuZhang	1
YimingMa	NaliniVenkatasubramanian	1
NickP.Clarke	Beng-SeukLee	1
PhilipS.Yu	HaixunWang	3
XiaosongMa	RobertFiedler	1
BobiGilburd	AssafSchuster	1
ZhanhuaiLi	YanTang	1
PeerKr*ger	AlexeyPryakhin	1
SamuelBushra	KunLiu	1
TokWangLing	TingChen	2
DorgivalOlavoGuedesNeto	AdrianoVeloso	1
SusanB.Davidson	GeorgeA.Mihaila	1
SeikyungJung	JanetWebster	1
GiorgosKokkinidis	AlexandraPoulovassilis	1
WeiHong	ShawnR.Jeffery	1
PhilippePucheral	JeanFerri*	1
SeanC.Rhea	BrentN.Chun	1
GianluigiGreco	AntonellaGuzzo	1
Shilong(Stanley)Yao	RichardT.Snodgrass	1
LingQin	JieShen	1
YiyuYao	JiajinHuang	1
StefanoLonardi	Chotirat(Ann)Ratanamahatana	1
ZhengChen	DouShen	2
PhilipA.Bernstein	AnastassiaAilamaki	1
RobertGwadera	MohamedF.Mokbel	1
YahikoKambayashi	SouravS.Bhowmick	1
HolgerMeyer	BirgerH*nsel	1
ThierryCruanes	BhaskarGhosh	1
SharadMehrotra	DmitriV.Kalashnikov	2
JosephM.Hellerstein	BoonThauLoo	2
SreeramRamachandaran	RohitJoshi	1
PeterScheuermann	OuriWolfson	1
RobertWilensky	JonathanTraupman	1
Mohand-SaidHacid	ArantzaIllarramendi	1
ShyamKapur	JignashuParikh	1
VipulKashyap	MassimoMecella	1
HiroshiMotoda	HiromitsuFujikawa	1
RobertHayward	OsmarR.Za*ane	1
ZhenHuaLiu	MuralidharKrishnaprasad	1
TimosK.Sellis	SpirosSkiadopoulos	1
YonatanAumann	MosheFresko	1
EvangelosKanoulas	BettySalzberg	1
WeiWang0009	BaileShi	3
ShalendraChhabra	ChristianSiefkes	2
TharamS.Dillon	ElizabethChang	1
TatsuyaAkutsu	AtsukoYamaguchi	1
VasiliVasiliZolotov	LeoGiakoumakis	1
Hans-PeterKriegel	AlexeyPryakhin	2
IriniFundulaki	BogdanCautis	1
Kwok-WaiCheung	Kwok-ChungAu	1
SiyamedS.Sinir	GokceLaleci	1
GoetzGraefe	ConorCunningham	1
TimothyRoscoe	IonStoica	1
LaraDeVinco	GiancarloRaiconi	1
CiroDonalek	AngeloCiaramella	1
LaurentMignet	DenilsonBarbosa	1
SabineMayer	MauricevanKeulen	1
SouripriyaDas	GeorgeEadon	1
ShyamKapur	DmitryPavlov	1
HuiXiong	HaesunPark	1
RuixiangSun	JunfaLiu	1
PavanReddivari	AnupamJoshi	1
ThomasRisse	OlgaDeTroyer	1
SanjayKumarMadria	JianYin	1
SharmaChakravarthy	RamanathanBalachandran	1
ShivnathBabu	RajeevMotwani	1
M.NedimAlpdemir	AnastasiosGounaris	1
WalidG.Aref	MingLu	1
MoustafaA.Hammad	AhmedK.Elmagarmid	1
JiajinHuang	ChunnianLiu	1
Zhongfei(Mark)Zhang	RuofeiZhang	1
JuntaeKim	JonathanL.Herlocker	1
DimitrisPapadopoulos	CarlottaDomeniconi	1
WolfgangLindner	J*rgSchuler	1
TakashiWashio	HiromitsuFujikawa	1
NagenderBandi	DivyakantAgrawal	1
HiromitsuFujikawa	AkihiroNakashima	1
SusanB.Davidson	CarlosA.Heuser	1
VolkerMarkl	IhabF.Ilyas	2
LingQin	LingChen	1
SiddarthRavinutala	JoshuaOldmeadow	1
YonatanAumann	JonathanSchler	1
ChunTang	AidongZhang	1
HasanM.Jamil	AvigdorGal	1
PaulBrown	AshrafAboulnaga	1
Wei-YingMa	Hua-JunZeng	5
JiaLi	ChenLi	1
VivekR.Narasayya	LuborKoll*r	1
PedroDomingos	Mausam	1
RosaMeo	MaristellaMatera	1
YufeiTao	GeorgeKollios	2
SurajitChaudhuri	ArunprasadP.Marathe	1
LauraChiticariu	DeepavaliBhagwat	1
ZhengChen	ShuichengYan	3
XiaoweiJiang	RamachandranVenkatesh	1
RaymondT.Ng	JamesChilson	1
G*r*meCanals	ClaudiaRoncancio	1
HongZhang	BalajiPadmanabhan	1
KemalAltintas	JehanWickramasuriya	1
Young-GabKim	Chang-JooMoon	1
HuanmeiWu	BettySalzberg	1
SergeAbiteboul	ArnaudSahuguet	1
PrasadM.Deshpande	ArnonAmir	1
MarttiJuhola	KalervoJ*rvelin	1
VikasKrishna	SavithaSrinivasan	1
YunyaoLi	H.V.Jagadish	1
PilhoKim	BinLiu	1
DavidBernholz	D.CalvinAndrus	1
ZhiqiangZheng	HaoqiangZheng	1
RalfSchenkel	AnjaTheobald	1
PierluigiDelNostro	PaoloAtzeni	1
NaliniVenkatasubramanian	CharlesHuyck	1
QimingHuang	JoshuaZhexueHuang	1
MohammadR.Kolahdouzan	CyrusShahabi	1
WagnerMeiraJr.	AdrianoVeloso	1
JessicaLin	EamonnJ.Keogh	3
WilliamS.Yerazunis	ShalendraChhabra	2
SilviaNittel	AnthonyStefanidis	1
LinDeng	JianPei	1
JeffreyF.Naughton	AhmedAyad	1
JeffreyScottVitter	AhmedK.Elmagarmid	1
KeithMarsolo	HongyuanLi	1
IhabF.Ilyas	AshrafAboulnaga	2
WalidG.Aref	ThanaaM.Ghanem	2
SamMardanbeigi	BoonThauLoo	1
WilfredNg	QingzhaoTan	1
DavidT.McWherter	AnastassiaAilamaki	1
LinanJiang	DavidB.Lomet	1
YuchangLu	Jian-TaoSun	1
IhabF.Ilyas	AnnChristineCatlin	1
TerumasaAoki	JuanD.Vel*squez	1
YannisDrougas	ChristosTryfonopoulos	1
Hye-YoungPaik	BoualemBenatallah	2
TakahiroHara	SanjayKumarMadria	1
YingluoWang	ShaochuanCheng	1
Jos*A.Blakeley	GideonSchaller	1
HoongKeeNg	HonWaiLeong	1
KakaliSarkar	JamesDull	1
MingC.Lin	BrandonLloyd	1
ShaveenGarg	M.Tamer*zsu	1
ZhengChen	BenyuZhang	4
GuyM.Lohman	ChristianGarcia-Arellano	1
SudiptoGuha	NickKoudas	1
PeterCarlin	JunFang	1
ManolisKoubarakis	ChristosGiannoukos	1
SophieChabridon	PhilippePucheral	1
RakeshAgrawal	RaghuKrishnapuram	1
LupingDing	BradfordPielech	1
UlrichR*ckert	StefanKramer	1
EdizSaykol	*zg*rUlusoy	1
LiseGetoor	KristinaLerman	1
YannisE.Ioannidis	GeorgiaKoutrika	1
TrevorP.Martin	BasimA.Majeed	1
TimosK.Sellis	NikosKarayannidis	1
StefanBehnel	JussiKangasharju	1
RodrigoSalvadorMonteiro	GeraldoZimbrao	1
RichUrmston	DavidBarta	1
TingLiu	KeYang	1
JeffG.Schneider	AndrewW.Moore	1
TimothyM.Sutherland	BradfordPielech	1
YufeiTao	NikosMamoulis	1
RenatoFerreira	DorgivalOlavoGuedesNeto	1
MingxinHuang	ChunnianLiu	1
DyceJingZhao	DikLunLee	1
YunChi	PhilipS.Yu	1
JieChen	HuidongJin	1
ToshiyukiAmagasa	TakashiHonishi	1
RuchitaBhargava	KunLiu	1
RajeevMotwani	ItaruNishizawa	1
JiangSu	HarryZhang	1
MichaelF.Worboys	AlexandrosLabrinidis	1
WynneHsu	BengChinOoi	1
Wang-ChienLee	JianliangXu	2
HectorGarcia-Molina	GaganAggarwal	1
JalelBen-Othman	G*r*meCanals	1
JenniferNeville	DavidJensen	2
RaviJanardan	HuiXiong	1
KeesJong	AntoineCornu*jols	1
Per-*keLarson	HongfeiGuo	2
JiongYang	AnthonyK.H.Tung	1
RobertR.Snapp	ByungSukLee	1
PatrickBlair	JamesDull	1
MalikAyedTubaishat	JianYin	1
JonathanGoldstein	HongfeiGuo	2
WensiXi	DouShen	1
StefanoSpaccapietra	ArantzaIllarramendi	1
TeruakiHomma	FuminoriAdachi	1
ScottShenker	RyanHuebsch	2
SteffenStaab	MassimoMecella	1
Yi-HungWu	Chung-WenCho	1
TakashiHonishi	MasatoshiYoshikawa	1
HengTaoShen	BinCui	1
MouniaLalmas	BenjaminPiwowarski	1
TimothyW.Finin	PavanReddivari	1
YonghuaWu	SharadMehrotra	1
Yi-anHuang	WeiFan	2
TrevorP.Martin	NickP.Clarke	1
Wolf-TiloBalke	UlrichG*ntzer	2
PhilippePucheral	PascalMolli	1
MaxJ.Egenhofer	IsabelF.Cruz	1
FanYang	BoXie	1
NaliniVenkatasubramanian	IosifLazaridis	1
MorHarchol-Balter	BiancaSchroeder	1
RobertoTagliaferri	AntoninoStaiano	1
MarceloArenas	LeonidLibkin	1
ShariqRizvi	AlbertoO.Mendelzon	1
PhilippAnokhin	JacobBerlin	1
StefanieScherzinger	BernhardStegmaier	2
YaliZhu	BradfordPielech	1
VipulKashyap	RudiStuder	1
GeoffreyI.Webb	FeiZheng	1
ZhenyuanWang	YongShi	1
JunAdachi	AtsuhiroTakasu	1
ChristianWiesner	AlfonsKemper	1
JunZhang	AlonY.Halevy	1
LiXu	DavidW.Embley	1
ThodorosTopaloglou	EvanW.Steeg	1
SergeRielau	AndreasBehm	1
RudiStuder	Mohand-SaidHacid	1
Ki-JouneLi	Hak-CheolKim	1
MuraliMani	HongSu	1
YannisTheodoridis	Y*celSaygin	1
PinarDuygulu	Jia-YuPan	1
TizianaCatarci	ErichJ.Neuhold	1
ShinichiMorishita	JunSese	1
LingLiu	KekeChen	1
ZhengChen	Chun-YiShi	1
SureshVenkatasubramanian	JatinChhugani	1
ScottFadden	SamLightstone	1
PhilipA.Bernstein	PeterMork	1
SurajitChaudhuri	AndrewWitkowski	1
NishantMehta	LupingDing	2
YuvalElovici	BrachaShapira	1
XiaoyongChai	CharlesX.Ling	1
ZhengxinChen	XiaojunChen	1
NitinKhandelwal	BenjaminBinYao	1
VipinKumar	MichaelSteinbach	3
RajeevMotwani	KameshMunagala	1
MohamedH.Ali	MohamedG.Elfeky	1
Jean-MarcPetit	FabienDeMarchi	1
RobertoAmato	AntoninoStaiano	1
H.V.Jagadish	DiveshSrivastava	1
ElkeA.Rundensteiner	DavidFinkel	1
JiaweiHan	JianyongWang	3
RuixiangSun	HaipengWang	1
Hye-YoungPaik	BryanHarianto	1
GeorgeOstrouchov	AlGeist	1
SrinivasanParthasarathy	DmitriiPolshakov	1
WeeSunLee	GaoCong	1
HanyuLi	ChaoChen	1
LipingYang	LiZhang	1
GideonSchaller	AlazelAcheson	1
ManhQ.Dinh	FabioCasati	1
KarlDias	DineshDas	1
RaymondT.Ng	KyuseokShim	1
UtkarshSrivastava	HectorGarcia-Molina	1
PatrickBlair	MartinKlein	1
QianShengCheng	BenyuZhang	1
DiegodiBernardo	AntoninoStaiano	1
HuaLu	DanLin	1
Shian-HuaLin	Hung-YuKao	1
SunilPrabhakar	MohamedF.Mokbel	1
LarsSchmidt-Thieme	Cai-NicolasZiegler	1
EricBloedorn	DanielVenese	1
LowellRosen	DanielVenese	1
Xiao-DongLiu	Jun-PengBao	1
HillolKargupta	DaMeng	1
Wei-YingMa	JiyingWang	1
JohannesGehrke	JayavelShanmugasundaram	1
BrunoCr*milleux	ArnaudSoulet	1
R.ScottCost	JoelSachs	1
SrinivasanParthasarathy	AmolGhoting	1
YanFu	RuixiangSun	1
LinanJiang	EvangelosKanoulas	1
JulianaFreire	AmolV.Wanjari	1
YirongXu	DavidJ.DeWitt	1
SeanC.Rhea	JosephM.Hellerstein	1
NagaK.Govindaraju	MingC.Lin	1
NickKoudas	BengChinOoi	2
WilliamI.Grosky	KinjiOno	1
JiongYang	JinzeLiu	1
LiyingZhang	KalpathiR.Subramanian	1
RachidGuerraoui	LucBouganim	1
XingboYu	NaliniVenkatasubramanian	1
SanjayAgrawal	ArunprasadP.Marathe	1
XiaoweiJiang	BeysimSezgin	1
ShiroOgasawara	ShinichiNakasuka	1
YiChen	SriramPadmanabhan	2
RudiStuder	F*lixSaltor	1
SamYuanSung	HuiXiong	1
HongjunLu	ChenyiXia	1
DongwonLee	BoLuo	1
KevinS.Beyer	AndreyBalmin	1
MatthewEricOtey	AmolGhoting	1
Jee-HyubKim	AlexMitchell	1
SiminHe	JunfaLiu	1
LaurenceA.F.Park	KotagiriRamamohanarao	1
JimMelton	AndrewEisenberg	3
VasiliyMalakhov	MasumSerazi	1
WeeKeongNg	Kok-LeongOng	1
RaymondT.Ng	Jong-HwaLim	1
MehmetEminD*nderler	CemilAlper	1
StevenW.Schlosser	AnastassiaAilamaki	1
WenfeiFan	MingXiong	1
NickRoussopoulos	AntoniosDeligiannakis	2
JianXu	HongjunLu	1
SumitNegi	RemaAnanthanarayanan	1
TharamS.Dillon	J.WennyRahayu	1
KevinS.McCurley	AndrewTomkins	1
QiongLuo	DyceJingZhao	1
ShawnR.Jeffery	FrederickReiss	1
GiuseppeLongo	AngeloCiaramella	1
MoustafaA.Hammad	MohamedG.Elfeky	1
KarlAberer	ArantzaIllarramendi	1
KanliangWang	JunTian	1
YingXu0002	HectorGarcia-Molina	1
Mohand-SaidHacid	ChristopheRey	1
HyoseopShin	AndreiV.Popov	1
RobertoAmato	AngeloCiaramella	1
KongyiZhou	JinyuWang	1
PaulWatson	AlvaroA.A.Fernandes	1
YugyungLee	SoonAeChun	1
GuoqiangPan	BenjaminJ.McMahan	1
ToshiyukiAmagasa	MasatoshiYoshikawa	1
KemalAltintas	DmitriV.Kalashnikov	1
ShengMa	DimitrisPapadopoulos	1
S.Muthukrishnan	OliverSpatscheck	1
GangWang	FrederickH.Lochovsky	1
MatthiasBender	GerhardWeikum	1
PilhoKim	AmarnathGupta	1
WeiguoFan	P*velCalado	1
VenkatKrishnamurthy	SanjayE.Sarma	1
SoumenChakrabarti	ShaveenGarg	1
Zo*Lacroix	DaveHislop	1
DesmondJ.Fitzgerald	AnastasiosGounaris	1
YaxiaoSong	BoHuang	1
Shilong(Stanley)Yao	ChristianS.Collberg	1
Zhongfei(Mark)Zhang	SandeepKhanzode	1
KwangRyelRyu	Hyuk-ChulKwon	1
SongtingChen	JunChen	1
HowardJ.Hamilton	CoryJ.Butz	1
MayankBawa	DilysThomas	1
MonicaScannapieco	F*lixSaltor	1
ValeryA.Petrushin	LatifurKhan	2
Wei-YingMa	ChenyongHu	1
YirongXu	KristenLeFevre	2
StefanoValtolina	ElisaBertino	1
JimengSun	BinLiu0002	1
WensiXi	Wei-YingMa	4
PrasenjitMitra	ChenLi	1
ImadRahal	AmalPerera	1
SandeepTata	RichardA.Hankins	1
MayaRamanath	JulianaFreire	1
MingxinHuang	JiajinHuang	1
JiaweiHan	DavidClutter	1
JunYang0001	HaoHe	2
JamesDull	DavidHandy	1
HiroyukiKitagawa	ChristosFaloutsos	2
TakeharuEda	TakashiHonishi	1
MasumSerazi	FeiPan	1
DonatoMalerba	AnnalisaAppice	1
YvesPetinot	C.LeeGiles	1
Mausam	DeepakVerma	1
HuanLiu	EhteshamHaque	1
IsaacG.Councill	HuiHan	1
MasonBendixen	BeysimSezgin	1
NobuhisaUeda	MinoruKanehisa	1
NatasaMilic-Frayling	MarkoGrobelnik	1
VassilisChristophides	GeorgeSamaras	1
FaridParvini	CyrusShahabi	1
EgidioL.Terra	CharlesL.A.Clarke	1
MasafumiHamamoto	ChristosFaloutsos	1
LeiChen0003	Jin-yiCai	1
RomilMittal	NareshNeelapala	1
Yen-YuChen	QingqingGan	1
WeiguoFan	Wei-YingMa	2
KarimBa*na	ChristopheRey	1
WeixuanXu	JingHe	1
AleksanderKolcz	AbdurChowdhury	1
GeoffreyS.Knauth	GaryKratkiewicz	1
MichaelJ.Franklin	AlonY.Halevy	1
LarsArge	KeYi	1
DavidGa**n	CarlesFarr*	1
JunjieGuo	JarekGryz	1
St*phaneGan*arski	GuyBernard	1
ThanaaM.Ghanem	MohamedY.Eltabakh	1
XiaopengXiong	SunilPrabhakar	1
YahikoKambayashi	MukeshK.Mohania	1
XiaoCao	WenpingSu	1
JayantMadhavan	AlonY.Halevy	2
NicholasLester	AmandaClare	1
YiyuYao	MingxinHuang	1
LorettaAuvil	DavidClutter	1
YingXu0002	UtkarshSrivastava	1
WalidG.Aref	MohamedH.Ali	1
WeiguoFan	Gui-RongXue	1
RobertaCochrane	Fatma*zcan	1
MinosN.Garofalakis	IoanaManolescu	1
WeiWang0011	HaifengJiang	2
HiroshiMamitsuka	AtsukoYamaguchi	1
ThomasRisse	ErichJ.Neuhold	1
RogerMingHiengTing	KotagiriRamamohanarao	1
AlejandroA.Vaisman	AlbertoO.Mendelzon	1
MitchCherniack	DavidMaier	1
PeterGatalsky	GennadyL.Andrienko	1
UtkarshSrivastava	KrishnaramKenthapadi	1
MuraliRamanathan	AidongZhang	1
HeikkiMannila	AristidesGionis	2
Yi-FengLin	Wen-LianHsu	1
S.Muthukrishnan	GrahamCormode	2
GuyBernard	BrunoDefude	1
RamachandranVenkatesh	EbruErsan	1
VladimirZbarsky	PrasadM.Deshpande	1
IstvanCseri	ElizabethJ.O'Neil	1
RedaAlhajj	MehmetKaya	1
XifengYan	PhilipS.Yu	1
RahulShah	AhmedK.Elmagarmid	1
NgaT.Nguyen	ChihLai	1
RaghuRamakrishnan	JonathanGoldstein	2
JunFang	EbruErsan	1
ZhenyuanWang	Kwong-SakLeung	1
Kian-LeeTan	HweeHwaPang	3
MinosN.Garofalakis	JohannesGehrke	1
JialieShen	AnneH.H.Ngu	2
Lien-FaLin	Chao-ChunChen	1
PhilippeCudr*-Mauroux	ErichJ.Neuhold	1
PeterKunath	MartinPfeifle	1
XiaohuiLiu	KarlFraser	1
QiangYang	QianShengCheng	1
Zheng(Jessica)Zhao	WendyHuiWang	1
SamuelBushra	PatrickBlair	1
XinZhang0002	SongtingChen	1
YannisTheodoridis	ElisaBertino	1
MohammadMahdian	ChristianBorgs	1
RuiYang	QiangJing	1
MichaelK.Ng	AndyM.Yip	1
JohnShepherd	AnneH.H.Ngu	2
DivyakantAgrawal	AbhishekGupta	1
YuqingWu	SurajitChaudhuri	1
SharadMehrotra	GeneTsudik	2
Wolf-TiloBalke	JasonXinZheng	1
MarcusA.Maloof	JeremyZ.Kolter	1
RuslanSalakhutdinov	GrigorisJ.Karakoulas	1
VenugopalGovindaraju	JianPei	1
MichalisVazirgiannis	MagdaliniEirinaki	1
GrahamCormode	FlipKorn	2
VolkerMarkl	VijayshankarRaman	3
RyanHuebsch	BrentN.Chun	1
UtkarshSrivastava	RajeevMotwani	1
DianaZhou	AmyWang	1
CuiYu	BinCui	1
StefanoCeri	AlessandroCampi	2
XibeiJia	MinosN.Garofalakis	1
VipulKashyap	SteffenStaab	1
VipinKumar	QiLi	1
DieterGawlick	AravindYalamanchi	1
RalfSchenkel	IoanaManolescu	1
WesleyW.Chu	QinghuaZou	1
ThomasRisse	EduardoMena	1
ErnestTeniente	CarlosBeltr*n	1
MaxJ.Egenhofer	AnthonyStefanidis	1
GiorgosKokkinidis	GeorgeSamaras	1
ZhaohuiWu	XuezhongZhou	1
YanleiDiao	ShariqRizvi	1
IoanaStanoi	HaoHe	1
PatrickPorter	BenjaminJ.McMahan	1
KrishnaGade	JianyongWang	1
NanWang0002	HasanM.Jamil	1
YuJiang	HaixunWang	1
Marie-OdileCordier	*lisaFromont	1
ChristianBorgs	AminSaberi	1
RalfSchenkel	BhavaniM.Thuraisingham	1
XiaofengMeng	DaofengLuo	1
RichardT.Snodgrass	FaizCurrim	1
Jos*A.Blakeley	EbruErsan	1
ZhongshengHua	LiangLiang	1
ShaveenGarg	LukaszGolab	1
TuomoKorenius	MarttiJuhola	1
JayavelShanmugasundaram	AshwinMachanavajjhala	1
RyanHuebsch	JosephM.Hellerstein	2
LorettaAuvil	GregPape	1
WeiLai	KangZhang	1
WimdeJonge	MichaelEgmont-Petersen	1
Jos*A.Blakeley	BeysimSezgin	1
XiaosongMa	MarianneWinslett	1
ZografoulaVagena	ChristopherMeek	1
YoungdukSeo	DonghyunKim	1
JieChen	GrahamJ.Williams	1
YunPeng	VishalDoshi	1
LucaDeSantis	F*lixSaltor	1
TorbenBachPedersen	DennisPedersen	1
ChristopherBesemann	AnneDenton	1
StephenE.Robertson	MichaelJ.Taylor	1
SusanneE.Hambrusch	MohamedF.Mokbel	1
YimingMa	KemalAltintas	1
Lee-FengChien	Chien-ChungHuang	1
TatsuyaAkutsu	NobuhisaUeda	1
RuggeroG.Pensa	J*r*myBesson	1
GregorLeban	BlazZupan	1
MafruzZamanAshrafi	KateA.Smith	1
YanChen	XiaofengMeng	1
JoelE.Richardson	JamesA.Kadin	1
QiangYang	DouShen	1
SriramPadmanabhan	RajeshBordawekar	1
StefanoLonardi	DonnaM.Nystrom	2
YongJoonLee	Joon-SungYoon	1
Zheng-YuNiu	Dong-HongJi	1
EbruErsan	ChristianKleinerman	1
UtkarshSrivastava	JenniferWidom	2
Zo*Lacroix	Maria-EstherVidal	1
SergeAbiteboul	NicoletaPreda	1
ZidongWang	XiaohuiLiu	1
WenyuanWang	ShanchanWu	1
TimothyW.Finin	LiDing	1
MichaelWatzke	JeffreyF.Naughton	1
DaxinJiang	AidongZhang	2
YildirayKabak	YavuzGurcan	1
SrikantaJ.Bedathur	AbhijitKadlag	1
Yong-IkYoon	JoonheeKwon	1
ShiweiTang	DongqingYang	3
WeiWang0009	MingshengHong	1
MarcoMesiti	AkmalB.Chaudhri	1
XiaobinMa	JinSoungYoo	1
HongyuanZha	Chao-HsienChu	1
OlgaDeTroyer	KarlAberer	1
SrujanaMerugu	JoydeepGhosh	2
XiaoweiJiang	PeterCarlin	1
Yuan-FangWang	EdwardY.Chang	1
MohamedF.Mokbel	IbrahimKamel	1
TeruakiHomma	HiromitsuFujikawa	1
PulyamonVihakapirom	KenCosh	1
RobertSchroko	NaokiAbe	1
ZhihuaSu	TengjiaoWang	1
ReneQuiniou	*lisaFromont	1
YoungTruong	XiaodongLin	1
MarkoDebeljak	BernardZenko	1
MichaelK.Ng	JoshuaZhexueHuang	2
KrishnamoorthySivakumar	HillolKargupta	1
YannisVelegrakis	AnastasiosKementsietsidis	1
TrevorP.Martin	DetlefNauck	1
S.Muthukrishnan	DiveshSrivastava	2
NicholasLester	HughE.Williams	1
Wen-ChiHou	AnandYendluri	1
YuGuoWang	LiangHuaiYang	1
HonggangZhang	AlazelAcheson	1
JingShan	BettySalzberg	1
VipulKashyap	LucaDeSantis	1
MarceloArenas	DenilsonBarbosa	1
MehmetA.Nacar	FilippoMenczer	1
YufeiTao	JimengSun	1
VineetAgrwal	LalitWangikar	1
VukErcegovac	RakeshAgrawal	1
LeoGiakoumakis	GideonSchaller	1
RaghuRamakrishnan	Jin-yiCai	1
SergioMarti	HectorGarcia-Molina	1
DinaQ.Goldin	AlexandrosLabrinidis	1
Xiao-DiZhang	Jun-YiShen	1
XuanZhou	Kian-LeeTan	1
EugenioOliveira	AlexessanderAlves	1
ThiruvalluvanM.G.	RaymieStata	1
ManliZhu	JunZhang	1
JianPei	AidongZhang	2
WesleyW.Terpstra	AlejandroP.Buchmann	1
RamdevKanapady	ChandrikaKamath	1
XueminLin	JianXu	1
ZhiyuanChen	KyuseokShim	1
XiaoxinYin	JiaweiHan	1
JunYang0003	DaweiDing	1
SudhirVerma	MichaelPatek	1
MichaelJ.Zwilling	GoetzGraefe	1
RicardoVilalta	NidalM.Zeidat	1
JasonY.Zien	AndreasNeumann	1
Xiao-DiZhang	Jun-PengBao	1
YaoLiu	PeterA.Ng	2
ThomasRisse	F*lixSaltor	1
NingZhong	MingxinHuang	1
ShuaiMa	ChanjunYang	1
StefanBehnel	LudgerFiege	1
YasushiSakurai	TakeharuEda	1
YaronKanza	CatrielBeeri	1
HamidPirahesh	GuyM.Lohman	3
JasonY.Zien	EugeneJ.Shekita	1
RalfSchenkel	GeorgeA.Mihaila	1
MassimoMecella	ErichJ.Neuhold	1
TuomoKorenius	JormaLaurikkala	1
ChandrikaKamath	AleksandarLazarevic	1
PaulBradley	Jee-HyubKim	1
MarkoGrobelnik	JafarAdibi	1
S.Sudarshan	AlbertoO.Mendelzon	1
JiashunJin	ChrisClifton	1
WesleyW.Terpstra	StefanBehnel	1
StratosPaulakis	CharalamposLampos	1
FlavioRizzolo	AlejandroA.Vaisman	1
RamakrishnanSrikant	ChristosFaloutsos	1
OmarBenjelloun	BogdanCautis	2
PraveenRao	BongkiMoon	1
MarcoMesiti	GeorgeA.Mihaila	1
NazliGoharian	LingMa	1
YunghsiangS.Han	WenliangDu	1
RobinMcEntire	MichaelBada	1
MiteshVasa	JamesDull	1
T.C.Lai	P.L.Yu	1
KunLiu	ChrisGiannella	1
YimingMa	RamaswamyHariharan	1
ChristianKleinerman	AlazelAcheson	1
ErhardRahm	AndreasThor	1
MonicaScannapieco	LaksV.S.Lakshmanan	1
NitinKhandelwal	M.Tamer*zsu	1
DavidWai-LokCheung	BenKao	1
OzgurD.Sahin	AmrElAbbadi	1
MariaHong	DongyeopRyu	1
Mohand-SaidHacid	EduardoMena	1
MasonBendixen	AlazelAcheson	1
MoustafaA.Hammad	MiretteS.Marzouk	1
VijayshankarRaman	SamLightstone	1
LinqiLiu	JunjieGuo	1
YongShi	Hai-FengGuo	1
KarlAberer	F*lixSaltor	1
NileshN.Dalvi	Mausam	1
DeepakAgrawal	DarylPregibon	1
WangChiewTan	GauravVijayvargiya	1
RobertoAmato	GiancarloRaiconi	1
SachindraJoshi	RaghuKrishnapuram	1
RajeevRastogi	MinosN.Garofalakis	3
Ming-SyanChen	Bi-RuDai	1
SusanKotsovolos	AnandManikutty	1
MohamedH.Ali	IhabF.Ilyas	1
WeiHong	SaileshKrishnamurthy	1
DesmondJ.Fitzgerald	ArijitMukherjee	1
ZhiyuanChen	SurajitChaudhuri	1
RuiYang	PanosKalnis	1
JianPei	DaxinJiang	2
GennaroMiele	AntoninoStaiano	1
GilPress	DavidBarta	1
NickP.Clarke	DetlefNauck	1
JasonTsong-LiWang	DennisShasha	1
YuQian	GangZhang	1
JenniferWidom	ItaruNishizawa	1
WenJin	RongGe	1
Y*celSaygin	OsmarR.Za*ane	1
Kai-UweSattler	GunterSaake	1
RonaldoC.Prati	GustavoE.A.P.A.Batista	1
WendyHuiWang	GaneshRamesh	1
KatherineG.Herbert	CathyH.Wu	1
XiMa	HweeHwaPang	1
OdedShmueli	GeorgeA.Mihaila	1
VijayKrishnan	ShipraAgrawal	1
NinaMishra	KrishnaramKenthapadi	1
YanCui	HongqiangLi	1
MartinTheobald	JensGraupmann	1
WilliamI.Grosky	J*r*meGodard	1
YavuzGurcan	AsumanDogac	1
GiuseppeLongo	DiegodiBernardo	1
YirongXu	RamakrishnanSrikant	2
SophieChabridon	PascalMolli	1
KeYang	AndrewW.Moore	1
YvesPetinot	VivekBhatnagar	1
MitchCherniack	AnuragMaskey	1
V*clavSn*sel	MichalKr*tk*	1
KyounghwanAn	BonggiJun	1
ZhengHuang	StephenJ.Wright	1
TharamS.Dillon	CarloWouters	1
HaoqiangZheng	BalajiPadmanabhan	1
Mich*leSebag	KeesJong	1
PeerKr*ger	KarinKailing	4
PatriciaSerrano-Alvarado	JalelBen-Othman	1
SurajitChaudhuri	Seung-wonHwang	1
Xiao-DongLiu	Jun-YiShen	1
MoustafaA.Hammad	IhabF.Ilyas	1
Yi-HungWu	Chang-RongLin	1
LichengJiao	FangLiu	1
RuggeroG.Pensa	Jean-Fran*oisBoulicaut	1
TakehisaYairi	ShiroOgasawara	1
VassiliosS.Verykios	LoredanaParasilitiProvenza	1
JianyongWang	CharuC.Aggarwal	2
YuqiangGuan	SuvritSra	1
AnastasiosGounaris	AlvaroA.A.Fernandes	1
DavidParker	AndrewS.Miner	1
KennethSalem	IvanT.Bowman	1
JamesCaverlee	DavidButtler	1
WeiwenYang	DmitriV.Kalashnikov	1
ToddC.Mowry	ShiminChen	1
ZunpingCheng	ChenWang	1
Jong-WonRoh	Byoung-KeeYi	1
RajasekarKrishnamurthy	RaghavKaushik	4
OlfaNasraoui	BamshadMobasher	1
KyounghwanAn	JietaeCha	1
MichaelBaranski	J*rgenVoss	1
MunirCochinwala	Chung-MinChen	1
J*rgSander	CorrineCheng	1
StefanoSpaccapietra	RudiStuder	1
WensiXi	JunYan	1
AnastassiaAilamaki	AlonY.Halevy	1
VijayshankarRaman	HamidPirahesh	2
NingKang	DanielBarbar*	1
JohannesGehrke	AlinDobra	1
XiaodongWu	Mong-LiLee	1
ShiroOgasawara	KoichiHori	1
SoumenChakrabarti	KrithiRamamritham	1
WeiguoFan	JunYan	1
VikasArora	MuralidharKrishnaprasad	1
AlexanderV.Lotov	AlexanderA.Kistanov	1
EduardoF.Galvez	ArvindArasu	1
IstvanCseri	GideonSchaller	2
SrinivasanParthasarathy	SameepMehta	2
Kwong-SakLeung	Hai-FengGuo	1
Ming-SyanChen	Jan-MingHo	1
YuJiang	XiaofengMeng	1
LeiChen0003	JamesJ.Schauer	1
HectorGarcia-Molina	DilysThomas	1
RonEguchi	DmitriV.Kalashnikov	1
JamesT.Scoggins	DavidBernholz	1
SurajitChaudhuri	ManojSyamala	1
Maria-EstherVidal	HymaMurthy	1
TizianaCatarci	OlgaDeTroyer	1
LupingDing	ElkeA.Rundensteiner	3
JianPei	ChunTang	1
PatrickE.O'Neil	IstvanCseri	1
SugatoBasu	MikhailBilenko	1
YavuzGurcan	SerkanKirbas	1
ThemisPalpanas	EamonnJ.Keogh	1
JunFang	BeysimSezgin	1
JehanWickramasuriya	AmnonMeyers	1
StephanSchosser	HagenH*pfner	1
YoshikiFukui	KeishiTajima	1
StevenW.Schlosser	MinglongShao	1
SophieChabridon	LucBouganim	1
GiancarloRaiconi	GennaroMiele	1
CristianMesiano	BrunoApolloni	1
JunRao	DanielC.Zilio	1
YuniXia	RahulShah	1
GeorgiaKoloniari	EvaggeliaPitoura	1
St*phaneGan*arski	PatriciaSerrano-Alvarado	1
SophieChabridon	ClaudiaRoncancio	1
PaulWatson	NormanW.Paton	1
NaliniVenkatasubramanian	DmitriV.Kalashnikov	2
VivekR.Narasayya	ArndChristianK*nig	1
Zo*Lacroix	LouiqaRaschid	1
NaliniVenkatasubramanian	KemalAltintas	1
PrasannaKumarDesikan	JaideepSrivastava	1
PaulH.Leng	FransCoenen	1
RonEguchi	NaliniVenkatasubramanian	1
WolfgangLehner	SvenSchmidt	1
VenugopalGovindaraju	ShambhuJ.Upadhyaya	1
SurajitChaudhuri	GautamDas	2
SamuelBushra	MartinKlein	1
DavidB.Skillicorn	DanielR.Catchpoole	1
ZhiqiangYang	RebeccaN.Wright	1
BhaskarGhosh	Beno*tDageville	1
VasileiosMegalooikonomou	GuoLi	1
TolgaBozkaya	SrikanthBellamkonda	1
RamaswamyHariharan	NaliniVenkatasubramanian	1
TokWangLing	JiahengLu	1
MartinKlein	DavidHandy	1
RuchitaBhargava	JamesDull	1
YanTang	KebinCui	1
XuejunYang	Qiang-liZhao	1
WilliamPerrizo	AnneDenton	1
ShaochuanCheng	JunTian	1
NickCercone	JiyeLi	1
MarkLevene	AlexandraPoulovassilis	1
ManhQ.Dinh	HalvardSkogsrud	1
KhaledYagoub	Beno*tDageville	1
YoonkyongLee	PedroDomingos	1
SaraComai	PieroFraternali	1
JignashuParikh	DmitryPavlov	1
RaymieStata	PatrickHunt	1
RajeevMotwani	JenniferWidom	2
PanosKalnis	AnthonyK.H.Tung	1
RobertoTagliaferri	AngeloCiaramella	1
Wen-LianHsu	Kuen-PinWu	1
MichaelBiwer	JensGraupmann	1
MarcCardle	DimitriosGunopulos	1
RenuKurienBostwick	GeoffreyS.Knauth	1
Jean-Fran*oisBoulicaut	J*r*myBesson	2
KrishnaG.Kulkarni	Jan-EikeMichels	1
SachindraJoshi	RemaAnanthanarayanan	1
ZhengxinChen	YongShi	1
XiangLian	DimitrisPapadias	1
JagannathanSrinivasan	EugeneInseokChong	1
GiuseppeLongo	GiancarloRaiconi	1
SumitNegi	RahulGupta	1
RongPan	PavanReddivari	1
Kian-LeeTan	AnthonyK.H.Tung	3
Min-SooKim0001	Mi-JeongKim	1
OwenCooper	MichaelJ.Franklin	1
VagelisHristidis	GerhardWeikum	1
OliverSeeliger	IstvanCseri	1
JunZhang	EmaNemes	1
KristenLeFevre	AmyWang	1
XiZhang	Mong-LiLee	1
TaoLi	MitsunoriOgihara	2
BirgerH*nsel	AndreZeitz	1
PhilipS.Yu	BugraGedik	1
UgurG*d*kbay	MehmetEminD*nderler	1
RaghuRamakrishnan	LeiChen0003	2
GennaroMiele	DiegodiBernardo	1
IsabelF.Cruz	AlexandrosLabrinidis	1
ZengjianHu	WenJin	1
SrikanthBellamkonda	AndrewWitkowski	1
XinWang	CamiloRostoker	1
HamidPirahesh	Fatma*zcan	1
YoonguKim	ChanjungPark	1
ChristianDigout	AlexandruComan	1
RichardNock	FrankNielsen	1
WeicaiZhong	FangLiu	1
JeanFerri*	BrunoDefude	1
RuthYueeZhang	RubenH.Zamar	1
RichardF.Helm	BudMishra	1
WangZhang	MasaruKitsuregawa	1
MitchCherniack	ArvindArasu	1
HuipingCao	GeorgeKollios	1
SrujanaMerugu	InderjitS.Dhillon	2
JehanWickramasuriya	CarterButts	1
WenweiXue	QiongLuo	2
JeanFerri*	ClaudiaRoncancio	1
SiddarthRavinutala	ChristopherLeckie	1
TingYu	DiveshSrivastava	1
VincentC.S.Lee	CliftonPhua	1
StefanoCeri	DanieleBraga	2
DuQ.Huynh	AnneH.H.Ngu	1
KeYi	JunYang0001	1
BarbaraCatania	AkmalB.Chaudhri	1
Shui-LungChuang	Lee-FengChien	2
OlgaDeTroyer	F*lixSaltor	1
VenkateshGanti	EugeneAgichtein	1
YufeiTao	FeifeiLi	1
WenGao	SiminHe	1
PatriciaSerrano-Alvarado	BrunoDefude	1
YuDeng	V.S.Subrahmanian	1
LauraChiticariu	GauravVijayvargiya	1
TobiasMayr	BertholdReinwald	1
JanVandenBussche	GottfriedVossen	1
KevinChen-ChuanChang	BingLiu	1
RuchitaBhargava	DavidHandy	1
JingShan	DavidB.Lomet	1
SihemAmer-Yahia	JulianaFreire	1
XiaopengXiong	WalidG.Aref	3
SergioR.Cuesta	Nicol*sdeAbajo	1
JiaweiHan	BinHe	1
VipulKashyap	ThomasRisse	1
VictorTeixeiradeAlmeida	JanoMoreiradeSouza	1
DikLunLee	BaihuaZheng	1
SumitGanguly	AbhinandanDas	1
WenGao	HaipengWang	1
ChristopheRey	BoualemBenatallah	2
Byung-HoonPark	AlGeist	1
ShuichengYan	BenyuZhang	3
HaiminLee	AmnonMeyers	1
EmilioCarrizosa	BelenMartin-Barragan	1
YuqingWu	KyuseokShim	1
SergeyMelnik	PhilipA.Bernstein	2
DetlefNauck	BasimA.Majeed	1
MichaelJ.Franklin	AnilEdakkunni	1
FredZemke	AndrewEisenberg	1
WeiWang	NicolasBruno	1
St*phaneGan*arski	JeanFerri*	1
PeterA.Ng	HuiXiong	1
SandeepMane	JamshidA.Vayghan	1
Yi-ChengTu	SunilPrabhakar	1
Kian-LeeTan	FengPan	1
FrancescoBonchi	BartGoethals	1
RobbertC.VanderLinden	Hansj*rgZeller	1
RuihuaSong	Ji-RongWen	1
WalidG.Aref	KhaledM.Elbassioni	1
St*phaneGan*arski	BrunoDefude	1
WilliamArrighi	TerenceCritchlow	1
RalfRantzau	ChristosFaloutsos	1
RuchitaBhargava	KakaliSarkar	1
VishalDoshi	R.ScottCost	1
YimingMa	DmitriV.Kalashnikov	1
TomoyukiUchida	TetsuhiroMiyahara	1
JunZhang0002	Dae-KiKang	1
San-YihHwang	JaideepSrivastava	1
VictorM.Markowitz	SusanB.Davidson	1
LouiqaRaschid	JensBleiholder	1
St*phaneGan*arski	ClaudiaRoncancio	1
LingLiu	DavidButtler	1
TorbenBachPedersen	JesperPedersen	1
JatinChhugani	DavidS.Johnson	1
MasonBendixen	EbruErsan	1
WagnerTruppel	ThemistoklisPalpanas	1
NickKoudas	AmitMarathe	2
HeikkiMannila	FotoN.Afrati	1
YingXu0002	KrishnaramKenthapadi	1
YasushiSakurai	MasatoshiYoshikawa	1
KarstenB*hm	GerhardHeyer	1
SriramPadmanabhan	GeorgeA.Mihaila	3
PhilippeCudr*-Mauroux	F*lixSaltor	1
MoninderSingh	MichaelPatek	1
P*velCalado	MarcosAndr*Gon*alves	1
YufeiTao	DavidW.Cheung	1
WenGao	ChunliWang	1
YimingMa	AmnonMeyers	1
MonicaScannapieco	MassimoMecella	1
ManuelBarrenaGarc*a	JingShan	1
SankarSubramanian	LeiSheng	1
DavidLiben-Nowell	DanielGruhl	1
SridharRajagopalan	AndreasNeumann	1
Mohand-SaidHacid	ArisM.Ouksel	1
TaoLin	JoachimSchaper	1
MurrayF.Brennan	AriD.Brooks	1
ElkeA.Rundensteiner	BinLiu	1
LucaDeSantis	ErichJ.Neuhold	1
YounghwanLim	YongJoonLee	1
KatsuyukiYamazaki	HiromitsuFujikawa	1
TimothyRoscoe	BoonThauLoo	1
SamuelMadden	Agn*sVoisard	1
MingshengHong	JianPei	1
WeiWang0009	JianPei	2
RonnyMelz	ChristianBiemann	1
PaoloMissier	GiansalvatoreMecca	1
GeromeMiklau	DanSuciu	1
MohamedY.Eltabakh	AnnChristineCatlin	1
JamesT.Scoggins	ErikThomsen	1
AlexandrosLabrinidis	A.Howard	1
BingLiu	BamshadMobasher	1
TerumasaAoki	AlejandroBassi	1
WijnandvanStam	KamalAli	1
Zhi-HuaZhou	DanWei	1
PhilipS.Yu	JiaweiHan	4
VolkerMarkl	PaulBrown	1
YanCui	MiZhou	1
ShashiShekhar	JinSoungYoo	1
WilliamArrighi	GhalebAbdulla	1
YingXu0002	MayankBawa	1
WeiguoFan	HuaLi	1
PatrickZimmer	GerhardWeikum	1
ThorstenJoachims	LarsBackstrom	1
VivekR.Narasayya	RavishankarRamamurthy	1
OwenCooper	EugeneWu0002	1
PanosM.Pardalos	HaesunPark	1
YiyuYao	NingZhong	2
LarsSchmidt-Thieme	GeorgLausen	1
JuntaeKim	HyungilKim	1
HengTaoShen	AnthonyK.H.Tung	1
PhilipS.Yu	KeWang	1
SophieChabridon	BrunoDefude	1
PeterKunath	MatthiasRenz	1
XiaohuaHu	MurrayF.Brennan	1
MikeLenaghan	DavidReiner	1
TizianaCatarci	ArantzaIllarramendi	1
SergioIlarri	EduardoMena	1
Jian-TaoSun	Chun-YiShi	1
ShiminChen	AnastassiaAilamaki	1
Jean-Fran*oisBoulicaut	ClaireLeschi	1
ThiruvalluvanM.G.	PatrickHunt	1
ZografoulaVagena	MichailVlachos	1
Kai-UweSattler	HagenH*pfner	1
ThomasReichherzer	DavidB.Leake	1
SandeepPandey	KedarDhamdhere	1
NormanMay	GuidoMoerkotte	1
KedongLuo	Jia-GuangSun	1
ShinyaKitaguchi	HidetoYokoi	1
Seung-wonHwang	KaushikChakrabarti	1
JunliChen	BaoyanLiu	1
SilviaNittel	MichaelF.Worboys	1
CuipingLi	AnthonyK.H.Tung	1
SamuelMadden	AmolDeshpande	1
MargaretH.Dunham	JieHuang	1
SabahCurrim	RichardT.Snodgrass	1
RamaswamyHariharan	DmitriV.Kalashnikov	1
P*velCalado	BaopingZhang	1
VassilKriakov	GeorgeKollios	1
LucyChernobrod	DmitryLenkov	1
JoachimSchaper	ChristofBornh*vd	1
IsabelF.Cruz	Agn*sVoisard	1
RameshNallapati	FuchunPeng	1
OmarBenjelloun	IriniFundulaki	1
FangLi	AthenaVakali	1
TharamS.Dillon	RobertMeersman	1
WilliamPerrizo	ImadRahal	2
SergioIlarri	ArantzaIllarramendi	1
VanjaJosifovski	MathiasM*rschel	1
NickKoudas	MichaelRabinovich	1
YanzanZhou	BamshadMobasher	1
YunChen	JigneshM.Patel	1
RuchitaBhargava	MartinKlein	1
WeiguoFan	Hua-JunZeng	1
NingZhong	JiajinHuang	1
VipinKumar	MaheshV.Joshi	1
PradeepB.Teregowda	C.LeeGiles	1
MarcoCristo	EdwardA.Fox	1
YoungTruong	ChrisBeecher	1
Beng-SeukLee	BasimA.Majeed	1
MotiSchneider	BrachaShapira	1
DineshManocha	BrandonLloyd	1
RaymondJ.Mooney	MaytalSaar-Tsechansky	1
SabineMassmann	HongHaiDo	1
YuvalElovici	AbrahamKandel	1
QiangYang	HaipengWang	1
Seung-SooPark	HyonHeeKim	1
Jan-EikeMichels	AndrewEisenberg	1
MarcusFontoura	JasonY.Zien	1
YutakaKidawara	KojiZettsu	1
QiangYang	JunYan	3
Mohand-SaidHacid	KarlAberer	1
MichaelJ.Franklin	GerhardWeikum	1
HananSamet	GlennS.Iwerks	1
ScottFadden	DanielC.Zilio	1
RaghuRamakrishnan	DavidR.Musicant	1
KyuseokShim	JungchulWoo	1
TokWangLing	DaofengLuo	1
XiaoyunWu	RohiniK.Srihari	2
ZhenZhang	KevinChen-ChuanChang	4
OlgaDeTroyer	ArisM.Ouksel	1
DiegodiBernardo	CiroDonalek	1
MichelangeloCeci	DonatoMalerba	1
Eun-YoungKim	DongyeopRyu	1
SivaRavada	KothuriVenkataRaviKanth	1
VishalDoshi	PavanReddivari	1
JosephM.Hellerstein	AmolDeshpande	2
RameshJain	PunitGupta	1
RuiCamacho	AlexessanderAlves	1
ShaulDar	GilHecht	1
RuiZhang0003	Kian-LeeTan	2
NobuhisaUeda	KiyokoF.Aoki	2
PietroMazzoleni	ElisaBertino	1
JoshuaAlspector	AbdurChowdhury	1
Xiao-DongLiu	Xiao-DiZhang	1
InderjitS.Dhillon	ArindamBanerjee	2
ShipraAgrawal	JayantR.Haritsa	1
OlivierSaidi	DavidVerbel	1
TuomoKorenius	KalervoJ*rvelin	1
RamachandranVenkatesh	AlazelAcheson	1
PatrickE.O'Neil	NigelWestbury	1
JietaeCha	BonggiJun	1
JoydeepGhosh	ArindamBanerjee	2
HaiminLee	DmitriV.Kalashnikov	1
QiangYang	JunfaLiu	1
RamnathBalasubramanyan	ByronDom	1
XiaohuaHu	Il-YeolSong	1
SeanC.Rhea	RyanHuebsch	1
RichardTibbetts	EstherRyvkina	1
SharadMehrotra	RonEguchi	1
StathesHadjiefthymiades	LazarosF.Merakos	1
RichardT.Snodgrass	MerrieBrucks	1
HonggangZhang	BeysimSezgin	1
YuePan	LipingYang	1
RameshNallapati	JamesAllan	1
Y*celSaygin	ElisaBertino	1
ShashiShekhar	Pang-NingTan	1
PavanReddivari	LiDing	1
OlgaDeTroyer	MonicaScannapieco	1
WeiHong	AnilEdakkunni	1
StefanSch*nauer	KarinKailing	2
YannisKotidis	AntoniosDeligiannakis	2
NuweeWiwatwattana	DiveshSrivastava	1
UpenPatil	ShamkantB.Navathe	1
MichaelGertz	GunterSaake	1
DmitryLenkov	DieterGawlick	1
SilviaNittel	MaxJ.Egenhofer	1
SergeAbiteboul	OmarBenjelloun	2
YirongYang	RichardR.Muntz	1
ShinichiMorishita	IsidoreRigoutsos	1
QinLv	KaiLi	1
VipinKumar	Pang-NingTan	5
VasiliyMalakhov	DongmeiRen	1
RudiStuder	MassimoMecella	1
SusanKotsovolos	JamesW.Warner	1
JoungWooRyu	EunJuKim	1
QiangDing	FeiPan	1
YangZhang	KebinCui	1
ThomasSeidl	KarinKailing	2
F*lixSaltor	ArisM.Ouksel	1
HughE.Williams	AmandaClare	1
ZhihongChong	JeffreyXuYu	1
MosesCharikar	KaiLi	1
FlorisGeerts	EvimariaTerzi	1
GerhardWeikum	GautamDas	1
HaofengZhou	ChenWang	2
KeYi	HaoHe	1
MinosN.Garofalakis	BhavaniM.Thuraisingham	1
YipingZhan	DeepayanChakrabarti	1
XiaofengMeng	HaixunWang	1
PunitGupta	BinWu	1
RicardoVilalta	Murali-KrishnaAchari	1
PaulG.Brown	IhabF.Ilyas	1
SunilPrabhakar	RaduSion	3
MichailVlachos	DimitriosGunopulos	4
JinwenMa	DikLunLee	1
JakeYueChen	AndreyY.Sivachenko	1
SaileshKrishnamurthy	FrederickReiss	1
Yi-FengLin	Tzong-HanTsai	1
JiZhang	HaiH.Wang	1
HuanLiu	AmitMandvikar	2
SteffenStaab	EduardoMena	1
WeixuanXu	JianpingLi	1
YuePan	LiMa	1
SilviaNittel	A.Howard	1
ThomasSeidl	JostEnderle	1
IsmailcemBudakArpinar	ChristianHalaschek-Wiener	1
ShuichengYan	QiangYang	3
BoualemBenatallah	AgnieszkaRutkowska	1
BogdanCautis	ArnaudSahuguet	1
MitchCherniack	MichaelStonebraker	1
RosaMeo	PierLucaLanzi	1
XiaobinMa	ShashiShekhar	1
ErikP.deVink	AnaSokolova	1
PeterScheuermann	GoceTrajcevski	1
FlavioRizzolo	AlbertoO.Mendelzon	1
YaZhang	Chao-HsienChu	1
NaokiAbe	JohnLangford	1
HamidPirahesh	FengTian	1
SvenHelmer	Carl-ChristianKanne	1
MaurizioMazza	ElisaBertino	1
EllaBingham	AtaKab*n	1
LaraDeVinco	GennaroMiele	1
MartinKlein	KakaliSarkar	1
MonicaScannapieco	ArisM.Ouksel	1
AnilK.Jain	AlexanderP.Topchy	2
RobertGwadera	MikhailJ.Atallah	1
HiroshiYasuda	AlejandroBassi	1
MilindR.Naphade	ApostolNatsev	1
ZehuaLiu	Ee-PengLim	1
PeerKr*ger	MatthiasSchubert	1
JessicaLin	DimitriosGunopulos	1
VijayshankarRaman	PeterJ.Haas	1
ScottShenker	IonStoica	2
AshwinSatyanarayana	AshishGrover	1
ShawnD.Newsam	ChandrikaKamath	1
KevinChen-ChuanChang	JiaweiHan	1
MarcoPatella	IreneNtoutsi	1
KevinS.Beyer	HamidPirahesh	1
RaymondJ.Mooney	MikhailBilenko	1
HaiminLee	CharlesHuyck	1
LianYan	DavidVerbel	1
YuXu	YannisPapakonstantinou	2
RobertGwadera	MohamedH.Ali	1
M.Tamer*zsu	GunterSaake	1
SteffenStaab	KarlAberer	1
PascalMolli	ClaudiaRoncancio	1
BryanHarianto	BoualemBenatallah	1
GiancarloRaiconi	AngeloCiaramella	1
YannisDrougas	StratosIdreos	1
RobertGwadera	MiretteS.Marzouk	1
Wei-YingMa	Ji-RongWen	2
PrasanRoy	AlbertoO.Mendelzon	1
Ting-YiSung	Kuen-PinWu	1
KotagiriRamamohanarao	JamesBailey	1
SandeepMane	JaideepSrivastava	1
SivaRavada	NingAn	1
ZhihengLi	GuimeiLiu	1
RahulSingh	BinWu	1
YannisE.Ioannidis	NeoklisPolyzotis	2
NickKoudas	HengTaoShen	1
YannisTheodoridis	VassiliosS.Verykios	1
ValterCrescenzi	GiansalvatoreMecca	1
F*lixSaltor	ArantzaIllarramendi	1
RachidGuerraoui	PhilippePucheral	1
NormanW.Paton	DesmondJ.Fitzgerald	1
Zhi-HuaZhou	HonghuaDai	2
WarwickGraco	GrahamJ.Williams	1
ScottFadden	JunRao	1
TobyBloom	TedSharpe	1
J*rgSchuler	DanielJ.Abadi	1
MuraliRamanathan	ChunTang	1
RolfIngold	DalilaMekhaldi	1
YvesVandePeer	SvenDegroeve	1
TizianaCatarci	EduardoMena	1
Yong-IkYoon	SungrimKim	1
YimingMa	CharlesHuyck	1
TakeharuEda	MasatoshiYoshikawa	1
RubenH.Zamar	LaksV.S.Lakshmanan	1
WikilKwak	JohnJ.Cheh	1
JunZhang	JayantMadhavan	1
MarcusFontoura	EugeneJ.Shekita	2
H.V.Jagadish	BengChinOoi	1
SudiptoGuha	ChulyunKim	1
JaideepVaidya	ChrisClifton	2
YunyueZhu	DennisShasha	1
SilviaNittel	IsabelF.Cruz	1
SumitGanguly	MinosN.Garofalakis	2
LanceParsons	EhteshamHaque	1
V.PaulPauca	RobertJ.Plemmons	1
SongtingChen	ElkeA.Rundensteiner	1
RamaswamyHariharan	CarterButts	1
Shyh-KweiChen	PhilipS.Yu	1
RachidGuerraoui	PatrickValduriez	1
XinXu	FengPan	1
DmitriV.Kalashnikov	AmnonMeyers	1
ToddOlsen	HillolKargupta	1
Fatma*zcan	AndreyBalmin	1
RobertoTagliaferri	DiegodiBernardo	1
YaxiaoSong	DanLin	1
JensGraupmann	ChristianZimmer	1
MohamedY.Eltabakh	MiretteS.Marzouk	1
DmitryPavlov	ByronDom	1
YildirayKabak	SerkanKirbas	1
HongjunLu	BengChinOoi	1
ShawnR.Jeffery	SeanC.Rhea	1
ZhihongChong	HongjunLu	1
ZhiyongHuang	YaxiaoSong	1
SpirosPapadimitriou	CuiZhu	1
StephenJ.Wright	JamesJ.Schauer	1
BirgerH*nsel	AndreasHeuer	1
HongZhang	AlexanderTuzhilin	1
MasumSerazi	DongmeiRen	1
NicoleSchweikardt	BernhardStegmaier	2
QiZhong	DawitYimamSeid	1
SunitaSarawagi	AbhayHarpale	2
SeogPark	JaehoonKim	1
StephenJ.Wright	Jin-yiCai	1
YuDeng	EdwardHung	1
JianPei	DikLunLee	1
XiaopengXiong	MiretteS.Marzouk	1
SophieChabridon	JalelBen-Othman	1
RaviKumar	D.Sivakumar	1
TokWangLing	Mong-LiLee	1
Jos*A.Blakeley	BalajiRathakrishnan	1
RamnathBalasubramanyan	DmitryPavlov	1
ManliZhu	KyriakosMouratidis	1
YildirayKabak	AsumanDogac	1
RaduSion	AhmedK.Elmagarmid	1
JudithA.Blake	JoelE.Richardson	1
OuriWolfson	GoceTrajcevski	1
DetlefNauck	Beng-SeukLee	1
WagnerTruppel	DimitriosGunopulos	1
ZhaohuiZheng	XiaoyunWu	1
SihemAmer-Yahia	ShashankPandit	1
KyuseokShim	ChulyunKim	2
ThanaaM.Ghanem	AhmedK.Elmagarmid	1
SandraD'Aguanno	AngelaBonifati	1
Y*celSaygin	VassiliosS.Verykios	1
ShariqRizvi	OwenCooper	1
FlipKorn	DiveshSrivastava	2
GerhardWeikum	DavidJ.DeWitt	1
SungSukKim	SangKeunLee	1
SharadMehrotra	CarterButts	1
SudarshanMurthy	ShawnBowers	1
XiaopengXiong	MohamedF.Mokbel	3
WynneHsu	HanyuLi	2
VassilisChristophides	GeorgeLoizou	1
LetiziaTanca	ElisaQuintarelli	1
DanielGruhl	AndrewTomkins	1
GiovanniConforti	GiorgioGhelli	1
LeonidZhukov	DavidGleich	1
MichaelPowers	JamesDull	1
YaZhang	HongyuanZha	1
PrakashLinga	JohannesGehrke	1
JeffreyConsidine	FeifeiLi	2
SihemAmer-Yahia	LaksV.S.Lakshmanan	1
JunZhang0002	AdrianSilvescu	1
SophieChabridon	PatriciaSerrano-Alvarado	1
KevinS.Beyer	EugeneJ.Shekita	1
ValterCrescenzi	PaoloMerialdo	1
PeterA.Boncz	NielsNes	1
OliverSeeliger	GideonSchaller	1
KeYi	IoanaStanoi	1
ShuaiMa	DongqingYang	2
LucBouganim	Fran*oisDangNgoc	1
MehdiSharifzadeh	AlbertA.Rizzo	1
ZhengHuang	RaghuRamakrishnan	2
RobertGwadera	AnnChristineCatlin	1
MenahemFriedman	MarkLast	1
VladimirZbarsky	ArnonAmir	1
YunZhou	W.BruceCroft	1
M.Tamer*zsu	Kai-UweSattler	1
JamesJ.Schauer	DeborahS.Gross	1
MichaelW.Kattan	MartinMozina	1
MohamedF.Mokbel	MingLu	1
SamuelBushra	DavidHandy	1
YiLifu	MasaruKitsuregawa	1
RonnyMelz	GerhardHeyer	1
VivekBhatnagar	PradeepB.Teregowda	1
RachidGuerraoui	JeanFerri*	1
HiroshiMotoda	FuminoriAdachi	1
YannisPetrakis	EvaggeliaPitoura	1
VasantHonavar	Dae-KiKang	1
ThomasRisse	SteffenStaab	1
OlafHoos	FabianM*rchen	1
StevenW.Schlosser	JiriSchindler	1
ThomasJ.E.Schwarz	RimMoussa	1
JosephM.Hellerstein	CarlosGuestrin	1
SurajitChaudhuri	LuborKoll*r	1
YunPeng	RongPan	1
ThomasR.Lynam	GordonV.Cormack	1
ThomasRisse	MassimoMecella	1
RobinDhamankar	PedroDomingos	1
MorganC.Wang	EricGottschalk	2
RalfSchenkel	GerhardWeikum	2
YannisTheodoridis	MarcoPatella	1
MelanieHilario	Jee-HyubKim	1
UtkarshSrivastava	NinaMishra	1
LiDing	AnupamJoshi	1
ZhihaiWang	GeoffreyI.Webb	1
GiuseppeLongo	AntoninoStaiano	1
XingboYu	SharadMehrotra	1
TaoCheng	Klaas-JanWinkel	1
PaoloFerragina	AntonioGulli	3
SelimAksoy	GiovanniB.Marchisio	1
MatthiasRenz	MartinPfeifle	1
YaliZhu	GeorgeT.Heineman	1
FidelisAssis	ChristianSiefkes	1
ScottFadden	AdamJ.Storm	1
ThorstenJoachims	RichCaruana	1
LeonidLibkin	DenilsonBarbosa	1
LingChen0002	Liang-TienChia	1
TomoyukiUchida	TakayoshiShoudai	1
SusanB.Davidson	EvanW.Steeg	1
YannisTheodoridis	LoredanaParasilitiProvenza	1
YiyuYao	ChunnianLiu	1
RamakrishnanSrikant	RakeshAgrawal	5
ThemistoklisPalpanas	DimitriosGunopulos	1
LazarosF.Merakos	GeorgeAlyfantis	1
BertramLud*scher	AlanNash	2
MiretteS.Marzouk	AhmedK.Elmagarmid	1
OmarBenjelloun	NicoletaPreda	1
Doo-KwonBaik	Dae-HaPark	1
LinanJiang	BettySalzberg	1
XiangJi	HongyuanZha	1
Pang-NingTan	AyselOzgur	1
YingXu0002	DilysThomas	1
MonicaScannapieco	DiveshSrivastava	1
SamMardanbeigi	IonStoica	1
TizianaCatarci	LucaDeSantis	1
JouniK.Sepp*nen	HeikkiMannila	2
ZhengxinChen	EugeneY.Sheng	1
ShiguangShan	RuixiangSun	1
YoonkyongLee	RobinDhamankar	1
QiHan	IosifLazaridis	1
PeterCarlin	MasonBendixen	1
ClaudiaRoncancio	BrunoDefude	1
Yan-NeiLaw	CarloZaniolo	1
PeriklisAndritsos	AnastasiosKementsietsidis	1
YunyueZhu	AlbertoLerner	1
RobinMcEntire	RobertStevens	1
JiaweiHan	CharuC.Aggarwal	2
PatrickValduriez	ClaudiaRoncancio	1
JoelSachs	AnupamJoshi	1
ZunpingCheng	DingZhou	1
PeterJ.Haas	PaulG.Brown	1
MuratKantarcioglu	ChrisClifton	2
XinXu	Kian-LeeTan	1
XinZhang0002	JunChen	1
PeriklisAndritsos	KennethC.Sevcik	1
KarimBa*na	FaroukToumani	1
QiangYang	CharlesX.Ling	1
ThomasG*rtner	StefanWrobel	1
WilliamM.Shui	RaymondK.Wong	1
V.PaulPauca	FarialShahnaz	1
WeeKeongNg	Ee-PengLim	4
MehdiEssid	Jean-YvesGarinet	1
EdoardoAiroldi	ChristosFaloutsos	1
PatrickValduriez	GerhardWeikum	1
J*r*mieMary	ElenaMarchiori	1
StefanoRizzi	BarbaraCatania	1
ManuelBarrenaGarc*a	BettySalzberg	1
Yan-huangJiang	Qiang-liZhao	1
WeiFan	PhilipS.Yu	3
Yuan-FangWang	AnkurJain	1
MichalisPetropoulos	ChristophQuix	1
LucBouganim	GuyBernard	1
JeffreyConsidine	GeorgeKollios	2
Hans-PeterKriegel	ChristianB*hm	1
MarkScardina	KongyiZhou	1
ZhiyongHuang	HonggaLi	1
YongYe	XintaoWu	1
KevinS.Beyer	BeverlyYang	1
RajasekarKrishnamurthy	JeffreyF.Naughton	4
RakeshAgrawal	AmeetKini	1
KatsuyukiYamazaki	AkihiroNakashima	1
GeorgeSamaras	AlexandraPoulovassilis	1
PeterCarlin	GideonSchaller	1
MasonBendixen	BalajiRathakrishnan	1
WesleyW.Chu	ChangLuo	1
BalajiPadmanabhan	AlexanderTuzhilin	1
ShankarPal	OliverSeeliger	1
YuePan	ShixiaLiu	1
GeorgeKollios	FeifeiLi	2
ShankarPal	IstvanCseri	2
SaraComai	MarcoDario	1
VishalDoshi	TimothyW.Finin	1
JunYan	ChenyongHu	1
EbruErsan	BeysimSezgin	1
MichailVlachos	GautamDas	1
HowardJ.Hamilton	GuichongLi	1
RichardHull	BharatKumar	1
ShiweiTang	JinqiangHan	1
HaixunWang	CarloZaniolo	1
SamMardanbeigi	RyanHuebsch	1
WilliamPerrizo	QiangDing	1
MichaelStonebraker	HariBalakrishnan	1
JensBleiholder	HymaMurthy	1
PaoloCiaccia	IreneNtoutsi	1
YachenLin	ChungChen	1
JiaweiHan	GregPape	1
Mi-JeongKim	Eun-KyuLee	1
YvesPetinot	PradeepB.Teregowda	1
GillesNiel	ClaudeLauren*o	1
IlvioBruder	AndreZeitz	1
TizianaCatarci	ThomasRisse	1
XinXu	JiongYang	1
SamuelMadden	NicolasBruno	1
StephanHaller	ChristofBornh*vd	1
RanieriBaraglia	FrancescoMerlo	1
RichUrmston	MikeLenaghan	1
MartinEster	Hans-PeterKriegel	1
PhilipA.Bernstein	MichalisPetropoulos	1
QiangYang	HuaLi	1
YiqiuHan	WaiLam	3
KevinKeenoy	AlexandraPoulovassilis	1
WilliamPerrizo	AmalPerera	1
V.PaulPauca	MichaelW.Berry	1
XueBai	RemaPadman	1
XueBai	EdoardoAiroldi	1
WensiXi	QiangYang	2
MarttiJuhola	JormaLaurikkala	1
NataliaV.Andrienko	GennadyL.Andrienko	1
TomazCurk	JanezDemsar	1
WalidG.Aref	AnnChristineCatlin	1
PhilipS.Yu	CharuC.Aggarwal	3
YorkSure	AndreasHotho	1
PaoloManghi	CarloSartiani	1
PengHan	BoXie	1
JayantMadhavan	EmaNemes	1
MichalKr*tk*	JaroslavPokorn*	1
VipinKumar	ShashiShekhar	2
TeruakiHomma	HiroshiMotoda	1
VivekR.Narasayya	BeverlyYang	1
ShinsukeNakajima	KatsumiTanaka	1
SimeonJ.Simoff	DanielR.Catchpoole	1
PrasannaGanesan	HectorGarcia-Molina	3
ArijitMukherjee	AnastasiosGounaris	1
RobertoEsposito	PierLucaLanzi	1
TeruakiHomma	TakashiWashio	1
JinwenMa	JianPei	1
FeiPan	DongmeiRen	1
SilviaNittel	DinaQ.Goldin	1
SrinivasanParthasarathy	MatthewEricOtey	1
TobiasMayr	FengTian	1
HuidongJin	HongxingHe	1
MarcoPatella	IlariaBartolini	1
ShaiBen-David	JohannesGehrke	1
KyriakosMouratidis	JunZhang	1
StefanoCeri	IoanaManolescu	1
RonEguchi	RamaswamyHariharan	1
KrishnaramKenthapadi	GaganAggarwal	1
ClementT.Yu	AnHaiDoan	1
ZhenHuaLiu	JamesW.Warner	1
SharadMehrotra	CharlesHuyck	1
MalcolmPotts	DeeptKumar	1
ShaiBen-David	DanielKifer	1
StefanoValtolina	ElenaFerrari	1
MohamedZa*t	Beno*tDageville	1
RahulShah	IhabF.Ilyas	1
EamonnJ.Keogh	DimitriosGunopulos	3
WeiHong	JosephM.Hellerstein	1
Mong-LiLee	ChaoChen	1
MatthiasKuntz	KaiLampka	1
MilindR.Naphade	JohnR.Smith	1
TonyF.Chan	MichaelK.Ng	1
FrankyLam	DamienK.Fisher	1
TakayoshiShoudai	HiroakiUeda	1
YasushiSakurai	TakashiHonishi	1
KedongLuo	JianminWang	1
Xiao-DiZhang	Hai-YanLiu	1
SamuelBushra	RuchitaBhargava	1
BarbaraCatania	AnnaMaddalena	2
YeHuang	NormanD.Black	1
LuigiPontieri	AntonellaGuzzo	1
GiuseppeManco	GianniCosta	1
MikeHanlon	Hansj*rgZeller	1
RuthYueeZhang	LaksV.S.Lakshmanan	1
VishalDoshi	JoelSachs	1
IlyaZaihrayeu	AndreiLopatenko	2
ZhengHuang	JamesJ.Schauer	1
DanielC.Zilio	AdamJ.Storm	1
NagenderBandi	AmrElAbbadi	1
QiLi	HaesunPark	1
StephenJ.Wright	RaghuRamakrishnan	1
RakeshAgrawal	DianaZhou	1
NigelWestbury	GideonSchaller	1
St*phaneGan*arski	SophieChabridon	1
NiteshV.Chawla	NathalieJapkowicz	1
QiangDing	ImadRahal	1
FabiusKlemm	AnwitamanDatta	1
PascalMolli	JeanFerri*	1
SaileshKrishnamurthy	AnilEdakkunni	1
RobertoJ.BayardoJr.	JerryKiernan	1
JesperPedersen	DennisPedersen	1
Wei-YingMa	ShuichengYan	3
GianniCosta	AndreaTagarelli	1
TakashiWashio	KenichiYoshida	1
FabioA.Schreiber	CristianaBolchini	1
ZografoulaVagena	DimitriosGunopulos	1
Yi-HungWu	ArbeeL.P.Chen	3
DavidB.Leake	AnaGabrielaMaguitman	1
TobiasKraft	HolgerSchwarz	1
PatriciaSerrano-Alvarado	LucBouganim	1
Ning-HanLiu	ArbeeL.P.Chen	1
Ya-HuiChang	Kun-MaoChao	1
YingGuangLi	St*phaneBressan	1
KarinKailing	ArthurZimek	1
SharadMehrotra	DawitYimamSeid	2
PhuChienNguyen	KouzouOhara	1
VikasKrishna	PrasadM.Deshpande	1
RobinDhamankar	AnHaiDoan	1
IoanaManolescu	AndreiArion	1
TizianaCatarci	RudiStuder	1
DomenicoSacc*	AntonellaGuzzo	1
LeoGiakoumakis	IstvanCseri	1
Wang-ChienLee	PengLiu	1
MarkoGrobelnik	HansChalupsky	1
VasiliyMalakhov	AmalPerera	1
YongYu	WensiXi	3
WeiguoFan	MarcoCristo	1
ArisM.Ouksel	ArantzaIllarramendi	1
StephanHaller	JoachimSchaper	1
KevinS.McCurley	ChristosFaloutsos	1
RajeevRastogi	JohannesGehrke	1
Hyung-JeongYang	ChristosFaloutsos	2
HongSu	ElkeA.Rundensteiner	1
YanFu	ChunliWang	1
RuiminShen	BoXie	1
JieChen	HongxingHe	1
JohnShepherd	JialieShen	2
QiangYang	LinDeng	1
MassimoMecella	F*lixSaltor	1
QiLi	HuiXiong	1
KarinKailing	AlexeyPryakhin	1
HyunsooKim	HaesunPark	1
JamesAllan	FuchunPeng	1
WalidG.Aref	AhmedK.Elmagarmid	3
KrzysztofKoperski	CarstenTusk	1
SimeonJ.Simoff	PaulJ.Kennedy	1
MiretteS.Marzouk	AnnChristineCatlin	1
SharadMehrotra	HakanHacig*m*s	2
RahulGupta	RaghuKrishnapuram	1
PedroDomingos	AlonY.Halevy	1
Young-KooLee	Won-YoungKim	1
DarioMalchiodi	CristianMesiano	1
S.AlirezaAghili	AmrElAbbadi	1
MaximilianViermetz	Hans-PeterKriegel	1
WalidG.Aref	MohamedF.Mokbel	6
VassilisChristophides	KevinKeenoy	1
MohamedZa*t	KarlDias	1
Yi-FengLin	Ting-YiSung	1
ZhenHe	RobertR.Snapp	1
PatrickZimmer	MichaelBiwer	1
HongjunLu	GabrielPuiCheongFung	1
RichardTibbetts	MichaelStonebraker	1
VasiliyMalakhov	FeiPan	1
XiaCao	ShuaiChengLi	1
M.NedimAlpdemir	DesmondJ.Fitzgerald	1
BrighamAnderson	AndrewW.Moore	1
SouravS.Bhowmick	QiankunZhao	2
Shui-FengShieh	Jia-LingKoh	1
WilliamO'Connell	AndrewWitkowski	1
FaroukToumani	BoualemBenatallah	2
XiaoyongChai	WilfredNg	2
PeerKr*ger	MaximilianViermetz	1
YunPeng	JoelSachs	1
RobertGwadera	AhmedK.Elmagarmid	1
ElenaFerrari	BhavaniM.Thuraisingham	1
MayankBawa	HectorGarcia-Molina	3
RaghavKaushik	JeffreyF.Naughton	4
Wang-ChienLee	DikLunLee	1
SunitaSarawagi	ShantanuGodbole	3
LichengJiao	JingLiu	1
P*velCalado	EdwardA.Fox	1
TizianaCatarci	KarlAberer	1
QiangDing	MasumSerazi	1
V*roniqueVentos	ThibautLamadon	1
KunLiu	HillolKargupta	2
VincentC.S.Lee	Denny	1
MurrayF.Brennan	AnnPrestrud	1
ZhenxingQin	LiLiu	1
LucBouganim	JeanFerri*	1
XiaosongMa	JohnNorris	1
Pang-NingTan	MichaelSteinbach	3
GiancarloRaiconi	DiegodiBernardo	1
WeiWang0009	DingZhou	1
VasilisVassalos	IoanaManolescu	1
SlawomirStaworko	JanChomicki	2
RamachandranVenkatesh	PeterCarlin	1
PatrickValduriez	BrunoDefude	1
Min-SooKim0001	Byoung-WooOh	1
Yan-huangJiang	XuejunYang	1
YvesVandePeer	YvanSaeys	1
WeihuaWu	MasumSerazi	1
DanielB.Neill	AndrewW.Moore	1
ChadM.Cumby	AndrewE.Fano	1
MarcosAndr*Gon*alves	BaopingZhang	1
MarcoCristo	BaopingZhang	1
ShuichengYan	QianShengCheng	1
NiteshV.Chawla	AleksanderKotcz	1
MichaelStonebraker	EstherRyvkina	1
YossiMatias	LeonPortman	2
TakehisaYairi	KoichiHori	1
JoachimHammer	AbdelsalamHelal	1
LucianPopa	JohnMylopoulos	1
Si*nCox	DavidG.Lindsay	1
VasantHonavar	AdrianSilvescu	1
TovaMilo	BogdanAlexe	1
ShengMa	DimitriosGunopulos	1
Jia-YuPan	Hyung-JeongYang	2
Jos*Hern*ndez-Orallo	C*sarFerri	1
ShawnR.Jeffery	SamMardanbeigi	1
PaulWatson	AnastasiosGounaris	1
MosheFresko	BinyaminRosenfeld	1
TetsuhiroMiyahara	KenichiTakahashi	1
SanjayAgrawal	ManojSyamala	1
MohamedZa*t	DineshDas	1
RobertoZanoli	FabrizioSebastiani	1
RudiStuder	MonicaScannapieco	1
SergeRielau	RichardSwagerman	1
WimdeJonge	ArnoSiebes	1
PatrickValduriez	JalelBen-Othman	1
RuixiangSun	ChunliWang	1
GeorgeKollios	AlexDelis	1
LuigiPontieri	DomenicoSacc*	1
TakehisaYairi	ShinichiNakasuka	1
SpirosSkiadopoulos	ChristosGiannoukos	1
RobertMeersman	ElizabethChang	1
TaoLiu	BenyuZhang	1
RanWolff	BobiGilburd	1
MartinRingwald	JoelE.Richardson	1
XiaoYang	KeyingYe	1
TeruakiHomma	KenichiYoshida	1
ShiguangShan	HaipengWang	1
NicolasSpyratos	KevinKeenoy	1
WeihuaWu	VasiliyMalakhov	1
HonggaLi	DanLin	1
NingKang	CarlottaDomeniconi	1
TengjiaoWang	DongqingYang	3
VishalDoshi	AnupamJoshi	1
Tze-YunLeong	SreeramRamachandaran	1
WesleyW.Chu	ShaorongLiu	1
MengLou	HaiH.Wang	1
DharmendraS.Modha	ArindamBanerjee	1
JussiMyllymaki	HamidPirahesh	1
Gui-RongXue	EdwardA.Fox	1
RajasekarKrishnamurthy	RaghuRamakrishnan	2
MehmetKoyut*rk	AnanthGrama	1
YanHuang	VipinKumar	1
TorstenSuel	QingqingGan	1
YannisKouvaras	TimosK.Sellis	1
WeiHong	CarlosGuestrin	1
MartinScholz	ChristopheFoussette	1
JinHu	ChenyiXia	1
JianPei	HaofengZhou	1
KeshengWu	EkowJ.Otoo	1
VictorM.Markowitz	EvanW.Steeg	1
I-AneHuang	Hung-YuKao	1
YihuaLiao	V.RaoVemuri	1
GideonSchaller	BeysimSezgin	1
TizianaCatarci	SteffenStaab	1
JonathanSchler	BinyaminRosenfeld	1
YufeiTao	ChristosFaloutsos	2
SteffenStaab	PhilippCimiano	1
MuraliRamanathan	DaxinJiang	1
YongJoonLee	MariaHong	1
OwenCooper	FrederickReiss	1
YanZhang	JianwenChen	1
IliasNitsos	DimitriosDervos	1
ManliZhu	DimitrisPapadias	1
KangZhang	GangZhang	1
ManuelBarrenaGarc*a	EvangelosKanoulas	1
RonEguchi	AmnonMeyers	1
OliverSpatscheck	DiveshSrivastava	1
YonghongPeng	PeterI.Cowling	1
JouniK.Sepp*nen	AristidesGionis	1
RemaAnanthanarayanan	NeerajAgrawal	1
DeepayanChakrabarti	ChristosFaloutsos	2
YaliZhu	ElkeA.Rundensteiner	2
PengLiu	DongwonLee	1
KristenLeFevre	DavidJ.DeWitt	1
DongqingYang	ChanjunYang	1
JunghooCho	ChangLuo	1
FuminoriAdachi	AkihiroNakashima	1
DineshDas	Beno*tDageville	1
Wei-YingMa	HuaLi	1
QiangYang	Gui-RongXue	1
YingFeng	DivyakantAgrawal	1
JoshuaZhexueHuang	EdmondHaoCunWu	1
LaraDeVinco	GiuseppeLongo	1
PhilipA.Bernstein	AlonY.Halevy	1
RamachandranVenkatesh	JunFang	1
BogdanAlexe	ArnaudSahuguet	1
ZhuoChen	TokWangLing	1
MarkdeBerg	LarsArge	1
J*r*myBesson	C*lineRobardet	1
MohamedF.Mokbel	JeffreyScottVitter	1
PeterCarlin	EbruErsan	1
Kwang-BaekKim	Byung-JooKim	1
ClaudeLauren*o	AmedeoNapoli	1
RobertoTagliaferri	CiroDonalek	1
RichardF.Helm	MalcolmPotts	1
EdizSaykol	CemilAlper	1
YuniXia	JeffreyScottVitter	1
PhilipS.Yu	Kun-LungWu	2
PatrickZimmer	MatthiasBender	1
Young-GabKim	Doo-KwonBaik	1
K.P.Unnikrishnan	JiaweiHan	1
Ji-RongWen	FrederickH.Lochovsky	1
MaartendeRijke	B*rkurSigurbj*rnsson	1
KeunHoRyu	Eung-JaeLee	1
EbruErsan	AlazelAcheson	1
JiongYang	JanPrins	1
MonicaScannapieco	LucaDeSantis	1
GeneTsudik	BijitHore	1
DaoyingMa	AidongZhang	1
MehmetS.Aktas	FilippoMenczer	1
RobertaCochrane	KevinS.Beyer	1
J*r*myBesson	ClaireLeschi	1
KrishnaP.Leela	JayantR.Haritsa	1
SaileshKrishnamurthy	MichaelJ.Franklin	2
PatriciaSerrano-Alvarado	G*r*meCanals	1
PhilippeCudr*-Mauroux	LucaDeSantis	1
RongPan	AnupamJoshi	1
YingYang	XindongWu	2
LeonardoGuerreiroAzevedo	JanoMoreiradeSouza	1
SumitNegi	SachindraJoshi	1
RameshJain	RahulSingh	1
Yan-NeiLaw	HaixunWang	1
TomZylkin	RonaldK.Pearson	1
TomaszF.Stepinski	FranciscoOcegueda-Hernandez	1
RosaMeo	RobertoEsposito	1
XiaodongLin	AlanF.Karr	1
XueLi	XingzhiSun	1
JeffreyF.Naughton	GangLuo	1
DivyakantAgrawal	ChengyuSun	1
TobiasMayr	JussiMyllymaki	1
ZengjianHu	MartinEster	1
Wai-ShingHo	EricLo	1
MarceloArenas	AnastasiosKementsietsidis	1
ShawnR.Jeffery	SaileshKrishnamurthy	1
Jin-yiCai	DeborahS.Gross	1
GianniCosta	AngelaBonifati	1
CharlesElkan	AndrewT.Smith	1
KameshMunagala	ItaruNishizawa	1
GiorgosKokkinidis	GeorgeLoizou	1
PatrickValduriez	PatriciaSerrano-Alvarado	1
SamLightstone	JunRao	1
RonenFeldman	JonathanSchler	1
StefanoCeri	MarcoBrambilla	1
PedroR.D'Argenio	MarioBravetti	1
RachidGuerraoui	G*r*meCanals	1
JensBleiholder	FelixNaumann	1
IlyaZaihrayeu	EnricoFranconi	2
SrikantaJ.Bedathur	JayantR.Haritsa	2
ShouyangWang	KinKeungLai	3
Shian-HuaLin	Jan-MingHo	1
TakashiHonishi	ShunsukeUemura	1
GeorgeKollios	DavidW.Cheung	1
RobertMeersman	CarloWouters	1
XintaoWu	LiyingZhang	1
TakashiWashio	KatsuyukiYamazaki	1
SandraBerasaluce	AmedeoNapoli	1
HymaMurthy	FelixNaumann	1
St*phaneGan*arski	PhilippePucheral	1
BharatKumar	ArnaudSahuguet	1
JanezDemsar	BlazZupan	2
NobuhisaUeda	HiroshiMamitsuka	2
ShuaiChengLi	BengChinOoi	1
MikeLenaghan	DavidBarta	1
SrikanthBellamkonda	SankarSubramanian	1
XiaohuaHu	AriD.Brooks	1
RonHutchison	AnneDenton	1
NormanW.Paton	M.NedimAlpdemir	1
YongShi	JingHe	1
AngelaBonifati	AndreaPugliese	1
ShinichiNakasuka	KoichiHori	1
MartinPfeifle	Hans-PeterKriegel	7
MohamedF.Mokbel	AhmedK.Elmagarmid	1
V*clavSn*sel	JaroslavPokorn*	1
HailingYu	DivyakantAgrawal	1
JeromeP.Reiter	AlanF.Karr	1
JamshidA.Vayghan	JaideepSrivastava	1
GiuseppeLongo	CiroDonalek	1
WeihuaWu	ImadRahal	1
YanFu	QiangYang	1
YanHuang	ShashiShekhar	1
ShiguangShan	ChunliWang	1
MarioA.Nascimento	AlexandruComan	1
HaoranWu	BingLiu	1
WojciechSzpankowski	MikhailJ.Atallah	1
MarcAnderson	AnneDenton	1
VivekGupta	VineetAgrwal	1
XiaodongWu	WynneHsu	1
JiaweiHan	HwanjoYu	1
ThomasSeidl	MarcoP*tke	1
VictorB.Zordan	ThemisPalpanas	1
MichaelWatzke	CurtJ.Ellmann	1
YannisVelegrakis	PeriklisAndritsos	1
OlfaNasraoui	BingLiu	1
ShiguangShan	QiangYang	1
ShiminChen	PhillipB.Gibbons	1
KemalAltintas	CarterButts	1
StephenJ.Wright	DavidR.Musicant	1
MosheFresko	JonathanSchler	1
VassilisChristophides	AlexandraPoulovassilis	1
VipinKumar	RaviJanardan	1
ScottT.Leutenegger	Ki-JouneLi	1
RuiZhang0003	NickKoudas	1
MatthiasRenz	Hans-PeterKriegel	1
PrasannaGanesan	KrishnaramKenthapadi	1
VijayshankarRaman	GuyM.Lohman	3
ThodorosTopaloglou	H.V.Jagadish	1
NavalK.Verma	NaokiAbe	1
WalidG.Aref	SunilPrabhakar	1
WeiguoFan	BaopingZhang	1
SatoshiMorinaga	KenjiYamanishi	1
WeicaiZhong	LichengJiao	1
SamLightstone	AdamJ.Storm	1
RamachandranVenkatesh	BalajiRathakrishnan	1
VasantHonavar	JunZhang0002	2
JayantR.Haritsa	AnoopJain	1
WarwickGraco	TatianaSemenova	1
PatriciaSerrano-Alvarado	JeanFerri*	1
XinZhang0002	ElkeA.Rundensteiner	1
WensiXi	EdwardA.Fox	1
GiovannaGuerrini	AkmalB.Chaudhri	1
ThomasM.Tirpak	AndreasSchaller	1
Joon-SungYoon	JaeGakHwang	1
Dae-HaPark	Chang-JooMoon	1
ZhongSu	YuePan	1
KirkScott	ImadRahal	1
XiaoliLi	Tze-YunLeong	1
TakayukiNakata	Jun-ichiTakeuchi	1
GauravVijayvargiya	DeepavaliBhagwat	1
TingChen	JiahengLu	1
LuoSi	JamesP.Callan	1
GaoCong	AnthonyK.H.Tung	5
Yi-HungWu	Ning-HanLiu	1
ZunpingCheng	WeiWang0009	1
ChristianHalaschek-Wiener	BoanergesAleman-Meza	1
JiaweiHan	DuaneSearsmith	1
RalfSchenkel	MarcoMesiti	1
RichardHull	JianwenSu	1
NickKoudas	ChenLi	1
MiretteS.Marzouk	IhabF.Ilyas	1
LeiChen0003	DeborahS.Gross	1
VasiliVasiliZolotov	GideonSchaller	1
BoanergesAleman-Meza	AmitP.Sheth	1
JensGraupmann	GerhardWeikum	1
NinaMishra	JenniferWidom	1
GideonSchaller	EbruErsan	1
SiminHe	HaipengWang	1
SunilPrabhakar	RahulShah	1
ThodorosTopaloglou	SusanB.Davidson	1
DimitrisPapadias	BettySalzberg	1
YifengZheng	SusanB.Davidson	1
MiteshVasa	MartinKlein	1
RakeshAgrawal	DmitriAsonov	1
WagnerTruppel	MichailVlachos	1
SunitaSarawagi	SoumenChakrabarti	2
PatrickBlair	MichaelPowers	1
TimothyRoscoe	BrentN.Chun	1
SandeepGopisetty	KaladharVoruganti	1
DongmeiRen	BaoyingWang	1
YingXu0002	RajeevMotwani	1
FrederickReiss	EugeneWu0002	1
SrikanthBellamkonda	NathanFolkert	1
VassilisChristophides	NicolasSpyratos	1
PeerKr*ger	MartinPfeifle	2
YongYu	Wei-YingMa	3
PeterJ.Haas	GuyM.Lohman	1
VipulKashyap	EduardoMena	1
JussiMyllymaki	BertholdReinwald	1
MohamedZiauddin	DineshDas	1
QingLi	JunYang0003	1
ImadRahal	FeiPan	1
YongYu	EdwardA.Fox	1
ZhihengLi	JeffreyXuYu	1
JayaprakashPisharath	AlokN.Choudhary	1
JaapKamps	B*rkurSigurbj*rnsson	1
IreneNtoutsi	IlariaBartolini	1
SiminHe	RuixiangSun	1
PeterA.Flach	C*sarFerri	1
JosephM.Hellerstein	IonStoica	2
JenniferWidom	HectorGarcia-Molina	1
Kok-LeongOng	Ee-PengLim	1
NuweeWiwatwattana	H.V.Jagadish	1
PhilippeCudr*-Mauroux	ArisM.Ouksel	1
YuqingWu	H.V.Jagadish	1
AngelaBonifati	AndreiArion	1
Jun-YiShen	Hai-YanLiu	1
JoshuaAlspector	AleksanderKolcz	1
Yi-anHuang	HaixunWang	1
MinoruKanehisa	HiroshiMamitsuka	1
SujoeBose	LeonidasFegaras	1
XibeiJia	WenfeiFan	2
ZhuomingXu	WenpingSu	1
RobbertC.VanderLinden	JohannesKlein	1
WeiWang0010	MingC.Lin	1
JayavelShanmugasundaram	AdinaCrainiceanu	1
DianaZhou	AmeetKini	1
YukWahWong	MoninderSingh	1
SumitGanguly	RajeevRastogi	2
M.NedimAlpdemir	AlvaroA.A.Fernandes	1
SudhirVerma	MoninderSingh	1
ZengjianHu	RongGe	1
Fran*oisRioult	BrunoCr*milleux	1
MehdiSharifzadeh	CyrusShahabi	1
RobinDhamankar	AlonY.Halevy	1
InderjitS.Dhillon	HyukCho	1
LaksV.S.Lakshmanan	GaneshRamesh	1
Mong-LiLee	HanyuLi	2
NicolasSpyratos	GiorgosKokkinidis	1
ShawnR.Jeffery	OwenCooper	1
SoonAeChun	JamesGeller	1
TizianaCatarci	MonicaScannapieco	1
WeihuaWu	FeiPan	1
SihemAmer-Yahia	FangDu	1
YvanSaeys	SvenDegroeve	1
ToreRisch	MattiasNystr*m	1
StratosIdreos	ManolisKoubarakis	3
GianniCosta	AndreaPugliese	1
ShenghuoZhu	PaatRusmevichientong	1
SubodhKumar	ShankarKrishnan	1
WeiguoFan	MarcosAndr*Gon*alves	1
DeeptKumar	BudMishra	1
KojiZettsu	KatsumiTanaka	1
TsutomuTerada	RieSawai	1
WalidG.Aref	SusanneE.Hambrusch	1
JunRao	GuyM.Lohman	1
MasonBendixen	JunFang	1
GeorgLausen	DanSuciu	1
JinHu	HongjunLu	1
HaoranWu	GaoCong	1
VanjaJosifovski	HamidPirahesh	1
MichaelK.Ng	EdmondHaoCunWu	2
PatrickBlair	MiteshVasa	1
KrishnaramKenthapadi	HectorGarcia-Molina	1
MatthiasSchubert	MartinEster	1
EricGottschalk	DavidS.Vogel	2
EstherRyvkina	DavidMaier	1
MarioA.Lopez	Ki-JouneLi	1
Mich*leSebag	ElenaMarchiori	1
ZhongSu	TaoLiu	1
ThomasL.Griffiths	MichalRosen-Zvi	1
SouravS.Bhowmick	Liang-TienChia	1
NishantMehta	GeorgeT.Heineman	1
MinqingHu	BingLiu	1
YuQian	KangZhang	2
YunPeng	LiDing	1
VassiliosS.Verykios	IgorNaiFovino	1
YounghwanLim	Eun-YoungKim	1
PeerKr*ger	ChristianB*hm	2
KevinKeenoy	GeorgeSamaras	1
RicardoA.Baeza-Yates	MarceloMendoza	1
SamLightstone	DanielC.Zilio	1
YongYu	DouShen	1
PrabhakarRaghavan	PavanKumarC.Singitham	1
RicardoJ.G.B.Campello	LeandroNunesdeCastro	1
DarioMalchiodi	AndreaBrega	1
Il-YeolSong	HyoilHan	1
PeterJ.Haas	ChristianKoenig	1
ShuichengYan	FengshanBai	1
NamitaSingla	MichaelKuperberg	1
AlexandrosLabrinidis	Agn*sVoisard	1
LingzhiZhang	JulianaFreire	1
PhilippePucheral	JalelBen-Othman	1
ZhuoChen	GillianDobbie	1
MahmutT.Kandemir	AlokN.Choudhary	1
XiangminJiao	MarianneWinslett	1
GeoffreyI.Webb	DhananjayR.Thiruvady	1
ZhengHuang	DeborahS.Gross	1
TakashiWashio	FuminoriAdachi	1
UtkarshSrivastava	DilysThomas	1
Il-YeolSong	AnnPrestrud	1
NarenRamakrishnan	BudMishra	1
VenkatKrishnamurthy	SudarshanS.Chawathe	1
JenniferWidom	GerhardWeikum	1
EranShaham	AvrahamA.Melkman	1
GongyiWu	BenyuZhang	1
RudiStuder	LucaDeSantis	1
OmarBoucelma	Jean-YvesGarinet	1
JuanD.Vel*squez	AlejandroBassi	1
YahikoKambayashi	QiankunZhao	1
HamidPirahesh	AlanHalverson	1
HuaLu	HonggaLi	1
JohannesGehrke	AbhinandanDas	1
DanielF.Lieuwen	ArnaudSahuguet	1
TakeharuEda	ShunsukeUemura	1
RichCaruana	LarsBackstrom	1
ZhihuaWang	XiaojianZhao	1
RichardSwagerman	AndreasBehm	1
MorHarchol-Balter	AnastassiaAilamaki	1
KaustavDas	AndrewW.Moore	1
VictorTeixeiradeAlmeida	GeraldoZimbrao	1
PatrickNoel	DimitreTrendafilov	1
SergioR.Cuesta	AlbertoB.Diez	1
Wei-GuangTeng	PhilipS.Yu	1
VishalDoshi	LiDing	1
KrishnamoorthySivakumar	DaMeng	1
VivekGupta	LalitWangikar	1
JehanWickramasuriya	CharlesHuyck	1
ByronChoi	ArekKasprzyk	1
SankarSubramanian	AbhinavGupta	1
MosheY.Vardi	GuoqiangPan	1
TobiasScheffer	SteffenBickel	1
TakehisaYairi	NaokiIshihama	1
JarekGryz	CalistoZuzarte	1
WeicaiZhong	JingLiu	1
WilliamM.Shui	FrankyLam	1
LaksV.S.Lakshmanan	DiveshSrivastava	1
GideonSchaller	ChristianKleinerman	1
TakashiWashio	KouzouOhara	1
XiaofengHe	ChrisH.Q.Ding	2
HongjunLu	HaifengJiang	2
EricLo	DavidWai-LokCheung	1
Yu-ChiangLi	Chien-ILee	1
DavidT.McWherter	BiancaSchroeder	1
SiminHe	QiangYang	1
RahulSingh	PunitGupta	1
RicardoA.Baeza-Yates	MarianoP.Consens	1
XueminLin	KaiXu0003	1
RichardF.Helm	DeeptKumar	1
SandraBerasaluce	ClaudeLauren*o	1
BengChinOoi	AnthonyK.H.Tung	5
ScottT.Leutenegger	MarioA.Lopez	1
AlexanderD.Zaitsev	AlexanderA.Kistanov	1
MartinScholz	DanielHakenjos	1
YutaoShou	DavidW.Cheung	1
Kuo-YuHuang	Chia-HuiChang	1
XiaopengXiong	AnnChristineCatlin	1
ScottFadden	GuyM.Lohman	1
YildirayKabak	SiyamedS.Sinir	1
YiSun	AtaKab*n	1
MarcoDario	MarcoBrambilla	1
IoanaManolescu	GianniCosta	1
MichaelF.Worboys	IsabelF.Cruz	1
PeterJ.Haas	AshrafAboulnaga	3
KrishnaG.Kulkarni	FredZemke	1
ShinichiMorishita	MohammedJaveedZaki	1
TokWangLing	GillianDobbie	1
NagizaF.Samatova	AlGeist	1
SilviaNittel	AmyBraverman	1
MonicaScannapieco	KarlAberer	1
RobertStevens	MichaelBada	1
TakahiroHara	NorishigeMurakami	1
RajeevMotwani	MayankBawa	2
WensiXi	QianShengCheng	1
MarceloMendoza	CarlosA.Hurtado	1
SuvritSra	InderjitS.Dhillon	1
TomoyukiUchida	TomonoriMogawa	1
MartinMozina	BlazZupan	1
KelvinT.Leung	AmyBraverman	1
Wai-ShingHo	DavidWai-LokCheung	1
PaoloManghi	GiorgioGhelli	1
PierLucaLanzi	MaristellaMatera	1
ThomasRisse	MonicaScannapieco	1
SreenivasGollapudi	D.Sivakumar	1
TimothyW.Finin	R.ScottCost	1
ParagSarda	AnoopJain	1
ThanaaM.Ghanem	MohamedG.Elfeky	1
YunjungYi	MarioGerla	1
PhilippeCudr*-Mauroux	Mohand-SaidHacid	1
JamesAllan	AoFeng	1
DammindaAlahakoon	CliftonPhua	1
ShawnR.Jeffery	BrentN.Chun	1
GeorgeEadon	EugeneInseokChong	1
MoustafaA.Hammad	MohamedH.Ali	1
Zo*Lacroix	Jean-YvesGarinet	1
ShuaiMa	JinqiangHan	1
YaliZhu	LupingDing	1
XinyuGuo	WynneHsu	1
MathiasM*rschel	AlanHalverson	1
RobertStevens	DanieleTuri	1
MushtaqAhmed	AdityaPhatak	1
VikasArora	AnandManikutty	1
PanayiotisTsaparas	KennethC.Sevcik	1
WenshengWu	AnHaiDoan	1
BrentN.Chun	BoonThauLoo	1
NathanFolkert	AndrewWitkowski	1
SimingHuang	ChaoSu	1
NickKoudas	Kian-LeeTan	1
YannisPapakonstantinou	VagelisHristidis	1
YingXu0002	JenniferWidom	1
XiaoxinYin	PhilipS.Yu	1
KeYin	IanDavidson	1
ChristopheRey	BryanHarianto	1
JeanFerri*	JalelBen-Othman	1
TheodoreDalamagas	AthenaVakali	1
S.Prabhakar	KarthikRamani	1
RobertoAmato	GennaroMiele	1
PieroFraternali	IoanaManolescu	1
YunChen	V.PrasadChakka	1
KennethA.Ross	JuliaStoyanovich	1
PanosVassiliadis	ChristosGiannoukos	1
SteffenStaab	ErichJ.Neuhold	1
HalvardSkogsrud	BoualemBenatallah	1
TizianaCatarci	MassimoMecella	1
HongVaLeong	GaryHoiKitLam	1
Mohand-SaidHacid	FaroukToumani	1
SumitNegi	NeerajAgrawal	1
ZhihaiWang	FeiZheng	1
MitchCherniack	EstherRyvkina	1
YuvalElovici	MarkLast	1
GuoliangYang	ChaoSu	1
LucaDeSantis	ArantzaIllarramendi	1
ZhenQiuLiu	JensGregor	1
V.G.VinodVydiswaran	SunitaSarawagi	1
IsmailcemBudakArpinar	BoanergesAleman-Meza	1
WenshengWu	ClementT.Yu	1
S.Muthukrishnan	FlipKorn	2
DinaQ.Goldin	AnthonyStefanidis	1
LingLiu	Kun-LungWu	1
HaipengWang	ChunliWang	1
MurrayF.Brennan	Il-YeolSong	1
YuvalElovici	MotiSchneider	1
KaidiZhao	AndreasSchaller	1
SurajitChaudhuri	KyuseokShim	1
JiongYang	FengPan	1
TimosK.Sellis	ManolisKoubarakis	1
DivyakantAgrawal	AmrElAbbadi	5
RicardoVilalta	FranciscoOcegueda-Hernandez	1
RachidGuerraoui	PatriciaSerrano-Alvarado	1
RonaldK.Pearson	GregoryE.Gonye	1
JianminWang	Jia-GuangSun	1
ToruTakaki	AtsushiFujii	1
SavithaSrinivasan	ArnonAmir	1
ShyamKapur	ByronDom	1
VanjaJosifovski	GuyM.Lohman	1
RubenH.Zamar	AlanWagner	1
MatthiasBender	MartinTheobald	1
WenfeiFan	PeterBuneman	1
JessicaLin	JeffreyP.Lankford	2
KyriakosMouratidis	DimitrisPapadias	2
YunPeng	AnupamJoshi	1
PeterTi*o	AtaKab*n	1
WeiZhao	ShengquanWang	1
ZhiyongHuang	BoHuang	1
Wang-ChienLee	DongwonLee	1
SasoDzeroski	BernardZenko	1
PeterCarlin	BeysimSezgin	1
MehmetEminD*nderler	*zg*rUlusoy	1
St*phaneGan*arski	LucBouganim	1
NatasaMilic-Frayling	DunjaMladenic	1
YiyuYao	ShinichiMurata	1
NicolasSpyratos	AlexandraPoulovassilis	1
MarcoMesiti	GiovannaGuerrini	2
ZhengChen	HuaLi	1
SubramanianArumugam	AbhijitPol	1
Mich*leSebag	J*r*mieMary	1
AnnChristineCatlin	AhmedK.Elmagarmid	1
VipulKashyap	Mohand-SaidHacid	1
VenkatesanT.Chakaravarthy	RajasekarKrishnamurthy	1
RobertF.Murphy	B.S.Manjunath	1
TheodoreJohnson	DiveshSrivastava	1
RamasamyUthurusamy	JiaweiHan	1
JenniferWidom	ArvindArasu	2
TorstenSuel	PatrickNoel	1
VipinKumar	HuiXiong	5
XinXu	GaoCong	2
YaronKanza	EliyahuSafra	1
TimothyW.Finin	RongPan	1
KarlAberer	AnwitamanDatta	1
ShawnR.Jeffery	MichaelJ.Franklin	1
GuidoMoerkotte	Carl-ChristianKanne	1
ZhihuaSu	LiyuLi	1
YvesKodratoff	OrianeMatte-Tailliez	1
DongwonLee	DiveshSrivastava	1
CristianMesiano	AndreaBrega	1
MichaelW.Kattan	BlazZupan	1
Wei-YingMa	QiangYang	4
YavuzGurcan	AliYildiz	1
PrasannaGanesan	DilysThomas	1
TovaMilo	IriniFundulaki	1
MarceloArenas	AlbertoO.Mendelzon	1
PhilipS.Yu	Ming-SyanChen	1
LetiziaTanca	FabioA.Schreiber	1
MihoOhsaki	HidetoYokoi	1
DanLin	ChristianS.Jensen	1
StefanSch*nauer	Hans-PeterKriegel	2
ZhaohuiWu	JunliChen	1
MiteshVasa	MichaelPowers	1
DavidMaier	AnuragMaskey	1
RajeevMotwani	BrianBabcock	1
RamaswamyHariharan	KemalAltintas	1
LeiSheng	AndrewWitkowski	1
JerzyMarcinkowski	JanChomicki	2
ThemisPalpanas	DimitriosGunopulos	1
MengLou	JiZhang	1
SumitK.Sanghai	Mausam	1
DavidFinkel	BinLiu	1
XiangminJiao	JohnNorris	1
SelimAksoy	CarstenTusk	1
NikosMamoulis	MariosHadjieleftheriou	1
YuchangLu	Wei-YingMa	1
ShawnR.Jeffery	ScottShenker	1
HanyuLi	BengChinOoi	1
JeffreyP.Lankford	DonnaM.Nystrom	2
WenJin	JiaweiHan	1
RichardF.Helm	NarenRamakrishnan	1
HuidongJin	GrahamJ.Williams	1
WeeSunLee	BingLiu	1
QiangYang	Hua-JunZeng	1
KaustavDas	JeffG.Schneider	1
NarainH.Gehani	KatherineG.Herbert	1
RonEguchi	KemalAltintas	1
PhilippeCudr*-Mauroux	OlgaDeTroyer	1
SouripriyaDas	EugeneInseokChong	1
GideonSchaller	BalajiRathakrishnan	1
YingXu0002	PrasannaGanesan	1
ErikG.Hoel	BettySalzberg	1
MichaelWatzke	GangLuo	1
WynneHsu	Mong-LiLee	7
WagnerMeiraJr.	DorgivalOlavoGuedesNeto	1
Wang-ChienLee	BoLuo	1
OliverSpatscheck	FlipKorn	1
RomilMittal	JayantR.Haritsa	1
Fran*oisLlirbat	Cristian-AugustinSaita	1
ElizabethJ.O'Neil	AlanFekete	1
YanifAhmad	Ugur*etintemel	1
MarioA.Lopez	Hak-CheolKim	1
YongYe	LiyingZhang	1
VenkateshGanti	SurajitChaudhuri	1
RameshNallapati	AoFeng	1
LucaDeSantis	EduardoMena	1
NeoklisPolyzotis	MinosN.Garofalakis	2
LucBouganim	JalelBen-Othman	1
PankajM.Tolani	JayantR.Haritsa	1
RichardR.Muntz	HaixunWang	1
RongPan	JoelSachs	1
HonggangZhang	BalajiRathakrishnan	1
HwanjoYu	DuaneSearsmith	1
PaoloGarza	ElenaBaralis	1
NinaMishra	MayankBawa	1
RobertFiedler	JohnNorris	1
SusanneE.Hambrusch	MoustafaA.Hammad	1
FrederickKnabe	DanielTunkelang	1
Maria-EstherVidal	FelixNaumann	1
FrancescoMerlo	FabrizioSilvestri	1
WilliamF.Punch	AnilK.Jain	1
MichaelGarland	JiaweiHan	1
OmarBoucelma	JulienVinel	1
NimeshNedungadi	GoceTrajcevski	1
ElenaMarchiori	AntoineCornu*jols	1
WenfeiFan	MinosN.Garofalakis	2
YihongDing	LiXu	1
PascalMolli	BrunoDefude	1
JingliLiu	JianpingLi	1
AnaL.N.Fred	AlexanderP.Topchy	1
RajeevMotwani	GaganAggarwal	1
YongShi	GangKou	1
MuraliMani	ElkeA.Rundensteiner	1
WeiwenYang	IosifLazaridis	1
St*phaneGan*arski	JalelBen-Othman	1
ShawnR.Jeffery	EugeneWu0002	1
DmitriV.Kalashnikov	CarterButts	1
SaraComai	MarcoBrambilla	1
GaoCong	CuipingLi	1
XiaoyongChai	QingzhaoTan	1
ShunsukeUemura	MasatoshiYoshikawa	1
StephenChi-faiChan	HongVaLeong	1
Wei-YingMa	GongyiWu	1
ChengkaiLi	BinHe	1
RobertL.Grossman	AndreiL.Turinsky	1
YouxuanJin	JonathanTang	1
SabineMayer	JensTeubner	1
YongJoonLee	JaeGakHwang	1
PatrickValduriez	JeanFerri*	1
XiaoMingZhou	TokWangLing	1
Nicol*sdeAbajo	AlbertoB.Diez	1
YuniXia	SunilPrabhakar	1
LangLi	AndreyY.Sivachenko	1
HiromitsuFujikawa	FuminoriAdachi	1
XiaoxinYin	JiongYang	1
V*roniqueVentos	HenrySoldano	1
MikeTyers	H.V.Jagadish	1
SrinivasanParthasarathy	DorgivalOlavoGuedesNeto	1
MalikAyedTubaishat	BiswajitPanja	1
ZongfangZhou	ZhanqinGuo	1
WangZhang	BotaoWang	1
PeterJ.Haas	IhabF.Ilyas	2
RichardT.Snodgrass	ChristianS.Collberg	1
PaulJ.McCullagh	NormanD.Black	1
J*r*meGodard	Fr*d*ricAndr*s	1
YusukeSuzuki	HiroakiUeda	1
V.RaoVemuri	AlejandroPasos	1
IanDavidson	AshwinSatyanarayana	1
PatrickPorter	GuoqiangPan	1
HuanmeiWu	DonghuiZhang	1
ShankarPal	NigelWestbury	1
Wei-YingMa	FengshanBai	1
ScottT.Leutenegger	Hak-CheolKim	1
KrzysztofKoperski	GiovanniB.Marchisio	1
OzgurD.Sahin	AbhishekGupta	1
RameshBhashyam	AndrewWitkowski	1
DanieleBraga	AlessandroCampi	2
Zo*Lacroix	FelixNaumann	1
TimosK.Sellis	TheodoreDalamagas	1
QiangYang	ChenyongHu	1
ThomasG*rtner	Tam*sHorv*th	1
MehdiSharifzadeh	FaridParvini	1
PeterCarlin	BalajiRathakrishnan	1
MohamedH.Ali	AnnChristineCatlin	1
MengchiLiu	GillianDobbie	1
SureshVenkatasubramanian	DavidS.Johnson	1
JohnJ.Cheh	HeeseokLee	1
WilliamPerrizo	VasiliyMalakhov	1
ChengXiangZhai	BeiYu	1
MichaelStonebraker	AnuragMaskey	1
WilliamO'Connell	SurajitChaudhuri	1
MatthiasWiesmann	Andr*Schiper	1
NishantMehta	ElkeA.Rundensteiner	2
AtsuyukiMorishima	AkiraMatsumoto	1
Tam*sHorv*th	StefanWrobel	1
Zo*Lacroix	AnnaMaddalena	1
YongShi	WikilKwak	1
FotoN.Afrati	AristidesGionis	1
MarcusDill	AchimKraiss	1
SharadMehrotra	BalakrishnaR.Iyer	3
RakeshAgrawal	ChristosFaloutsos	1
MohamedY.Eltabakh	IhabF.Ilyas	1
ShixiaLiu	LipingYang	1
MarkusHegland	GrahamJ.Williams	1
MarcosAndr*Gon*alves	MarcoCristo	1
XiaosongMa	XiangminJiao	1
MayankBawa	JenniferWidom	1
MarianneWinslett	C.Mohan	1
JohnW.Byers	FeifeiLi	1
BernhardZeller	AlfonsKemper	1
GiuseppeLongo	GennaroMiele	1
JonathanTang	AdamYeh	1
Val*rieIssarny	JinshanLiu	1
LinDeng	JinwenMa	1
SurajitChaudhuri	ArndChristianK*nig	1
Hans-PeterKriegel	EshrefJanuzaj	2
LoretoBravo	LeopoldoE.Bertossi	1
YonghuaWu	BalakrishnaR.Iyer	1
ZhiqiangZheng	BalajiPadmanabhan	1
RobertoAmato	CiroDonalek	1
ChiLapYip	BenKao	1
Zo*Lacroix	JensBleiholder	1
JosephM.Hellerstein	GarrettJacobson	1
WeixuanXu	JingliLiu	1
SerkanKirbas	AliYildiz	1
GoetzGraefe	C*sarA.Galindo-Legaria	1
StefanoLonardi	JeffreyP.Lankford	2
PatrickBlair	KunLiu	1
Mich*leSebag	Marie-ChristineRousset	1
XiaoweiJiang	Jos*A.Blakeley	1
MohamedG.Elfeky	IhabF.Ilyas	1
EvangelosKanoulas	DavidB.Lomet	1
KhuzaimaDaudjee	KennethSalem	1
TimosK.Sellis	ChristosGiannoukos	1
MarcoMesiti	ElisaBertino	1
ManolisKoubarakis	ChristosTryfonopoulos	3
ValeryA.Petrushin	AnneKao	1
NormanW.Paton	AlvaroA.A.Fernandes	1
ZhengChen	NingLiu	1
PavanReddivari	JoelSachs	1
YildirayKabak	GokceLaleci	1
RonEguchi	HaiminLee	1
YifengZheng	YiChen	1
OlgaDeTroyer	ArantzaIllarramendi	1
WeiWang0010	JunHuan	1
ThomasSeidl	Hans-PeterKriegel	3
PaoloMissier	PaoloMerialdo	1
ShashankPandit	LaksV.S.Lakshmanan	1
RaviJanardan	QiLi	2
YanHuang	JinSoungYoo	1
LoisM.L.Delcambre	DavidMaier	1
TatianaSemenova	GrahamJ.Williams	1
ThierryCruanes	Beno*tDageville	1
YanFu	SiminHe	1
PauloJ.F.Carreira	HelenaGalhardas	1
SusanB.Davidson	H.V.Jagadish	1
MichaelPowers	MartinKlein	1
MingshengHong	HaofengZhou	1
EnricoFranconi	AndreiLopatenko	2
HyoilHan	AriD.Brooks	1
PaulWatson	M.NedimAlpdemir	1
ZhengChen	ChenyongHu	1
ZhuomingXu	XiaoCao	1
YizhouWang	FangChu	1
ReynoldCheng	RahulShah	1
VincentT.Y.Ng	BennyY.M.Fung	1
ErikThomsen	D.CalvinAndrus	1
TolgaBozkaya	SankarSubramanian	1
MoustafaA.Hammad	MohamedF.Mokbel	2
SandraD'Aguanno	AndreiArion	1
Won-YoungKim	JiaweiHan	1
MaxJ.Egenhofer	DinaQ.Goldin	1
TatsuyaAkutsu	KiyokoF.Aoki	1
SenZhang	JasonTsong-LiWang	1
VagelisHristidis	SurajitChaudhuri	1
OlgaDeTroyer	Mohand-SaidHacid	1
JafarAdibi	DunjaMladenic	1
SridharRajagopalan	MarcusFontoura	2
XuezhongZhou	BaoyanLiu	1
WeiHong	AmolDeshpande	1
KemalAltintas	HaiminLee	1
Dae-KiKang	AdrianSilvescu	1
SeanC.Rhea	ScottShenker	1
KyounghwanAn	BongheeHong	1
SabahCurrim	FaizCurrim	1
DingZhou	ChenWang	1
KiyokoF.Aoki	HiroshiMamitsuka	2
RemaAnanthanarayanan	RaghuKrishnapuram	1
ChrisJermaine	AbhijitPol	1
RonaldK.Pearson	JamesS.Schwaber	1
KeesJong	ElenaMarchiori	1
RuiminShen	FanYang	1
YanleiDiao	MichaelJ.Franklin	1
YukWahWong	MichaelPatek	1
TatsuyaAkutsu	MinoruKanehisa	1
MarcusFontoura	AndreasNeumann	1
YaoLiu	HuiXiong	1
ThanaaM.Ghanem	MohamedH.Ali	1
LinDeng	CharlesX.Ling	1
GilPress	DavidReiner	1
SpirosPapadimitriou	HiroyukiKitagawa	1
LucBouganim	BrunoDefude	1
PeterCarlin	ChristianKleinerman	1
Ren*eJ.Miller	PanayiotisTsaparas	2
PhilipS.Yu	LingLiu	1
RichardTibbetts	AnuragMaskey	1
CharlesHuyck	CarterButts	1
Dong-HongJi	ChewLimTan	1
PankajM.Tolani	KrishnaP.Leela	1
DanielHakenjos	ChristopheFoussette	1
SirishChandrasekaran	MichaelJ.Franklin	1
SeokkyungChung	DennisMcLeod	1
PhilippePucheral	GuyBernard	1
S.AlirezaAghili	DivyakantAgrawal	1
TongZhang	JinboBi	1
VolkerMarkl	DavidE.Simmen	2
IanDavidson	GiriKumarTayi	1
ZunpingCheng	HaofengZhou	1
ZhenHuaLiu	SusanKotsovolos	1
XinZhang	NikosMamoulis	1
ShyamKapur	RamnathBalasubramanyan	1
ShariqRizvi	AnilEdakkunni	1
VictorM.Markowitz	H.V.Jagadish	1
ZhengChen	GongyiWu	1
WenGao	QiangYang	1
QingzhaoTan	DikLunLee	1
NuweeWiwatwattana	MonicaScannapieco	1
PedroDomingos	NileshN.Dalvi	1
YishengDong	XiaoCao	1
MonicaScannapieco	EduardoMena	1
PeerKr*ger	Hans-PeterKriegel	6
HuiHan	C.LeeGiles	1
YiqingTu	GangLi	1
WynneHsu	JunmeiWang	1
PhilipBohannon	PeterBuneman	1
PatriciaSerrano-Alvarado	PascalMolli	1
MartinTheobald	GerhardWeikum	2
RakeshNagarajan	AdityaPhatak	1
BrighamAnderson	AndrewConnolly	1
SusanB.Davidson	SriramPadmanabhan	1
SiminHe	ChunliWang	1
XibeiJia	MingXiong	1
ZhengChen	XuanhuiWang	1
MichaelF.Worboys	DinaQ.Goldin	1
Murali-KrishnaAchari	FranciscoOcegueda-Hernandez	1
NinaMishra	GaganAggarwal	1
TerenceCritchlow	GhalebAbdulla	1
LingChen	JieShen	1
PeterA.Flach	Jos*Hern*ndez-Orallo	1
JietaeCha	BongheeHong	1
ZhihuaSu	ShiweiTang	1
YasuakiNakamura	TomonoriMogawa	1
RudiStuder	OlgaDeTroyer	1
ZhiyuanChen	YuqingWu	1
JamesDull	HillolKargupta	1
SurajitChaudhuri	KaushikChakrabarti	1
KhaledM.Elbassioni	IbrahimKamel	1
XiaCao	AnthonyK.H.Tung	1
Hye-YoungPaik	FaroukToumani	2
MichaelJ.Franklin	JosephM.Hellerstein	1
NicoleSchweikardt	ChristophKoch	2
LaraDeVinco	AntoninoStaiano	1
RobertoTagliaferri	RobertoAmato	1
TingLiu	AndrewW.Moore	1
RobertaCochrane	AndreyBalmin	1
XinXu	AnthonyK.H.Tung	2
LuborKoll*r	ArunprasadP.Marathe	1
MarcusGr**er	FrankCiesinski	1
JunjiTomita	HidekazuNakawatase	1
St*phaneGan*arski	G*r*meCanals	1
QingLi	DaweiDing	1
UtkarshSrivastava	GaganAggarwal	1
KhaledYagoub	DineshDas	1
RemcoR.Bouckaert	EibeFrank	1
MafruzZamanAshrafi	DavidTaniar	1
SaraComai	IoanaManolescu	1
GiorgioGhelli	CarloSartiani	1
RajeshBordawekar	GeorgeA.Mihaila	1
MichaelF.Worboys	MaxJ.Egenhofer	1
DivyakantAgrawal	AhmedMetwally	1
YaBingChen	TokWangLing	1
ZhenxingQin	ShichaoZhang	1
EkowJ.Otoo	ArieShoshani	1
MagdaliniEirinaki	CharalamposLampos	1
KarlAberer	EduardoMena	1
NatalyaFridmanNoy	AnHaiDoan	2
YifanLi	JiongYang	1
GeorgGottlob	ChristophKoch	1
NormanW.Paton	AnastasiosGounaris	1
HiraAgrawal	DavidRosenbluth	1
ZhengxinChen	ShinParker	1
XiaofangZhou	KaiXu0003	1
YiPeng	XiaojunChen	1
SteffenStaab	StefanoSpaccapietra	1
ShaveenGarg	KrithiRamamritham	1
FabioCasati	BoualemBenatallah	1
FrederickReiss	AnilEdakkunni	1
NileshN.Dalvi	DeepakVerma	1
SridharRajagopalan	JasonY.Zien	1
ZhengChen	Wei-YingMa	9
MiteshVasa	KakaliSarkar	1
XifengYan	HongCheng	1
XinZhang	DavidW.Cheung	1
HengTaoShen	CuiYu	1
Jan-EikeMichels	FredZemke	1
XinDong	IgorTatarinov	1
VassiliosS.Verykios	ElisaBertino	1
ZacharyG.Ives	DanielS.Weld	1
YoonkyongLee	AlonY.Halevy	1
XiaoweiJiang	AlazelAcheson	1
SophieChabridon	GuyBernard	1
ShariqRizvi	PrasanRoy	1
ChrisBuckley	CharlesL.A.Clarke	1
PeterScheuermann	NimeshNedungadi	1
WilliamH.Piel	CathyH.Wu	1
DavidJ.DeWitt	AlonY.Halevy	1
J.WennyRahayu	ElizabethChang	1
OmerZaafrany	BrachaShapira	1
WenliangDu	ShigangChen	1
SudarshanS.Chawathe	SanjayE.Sarma	1
YingFeng	AhmedMetwally	1
YannisKouvaras	NikosKarayannidis	1
WarwickGraco	MarkusHegland	1
YimingMa	HaiminLee	1
RudiStuder	ErichJ.Neuhold	1
RachidGuerraoui	GuyBernard	1
IlyaZaihrayeu	GabrielM.Kuper	2
MarcosAndr*Gon*alves	EdwardA.Fox	1
StefanoSpaccapietra	PhilippeCudr*-Mauroux	1
Per-*keLarson	JonathanGoldstein	3
XiangZhang	MartinEster	1
PhilipA.Bernstein	MichaelJ.Franklin	1
KameshMunagala	JenniferWidom	1
YuvalElovici	OmerZaafrany	1
PascalMolli	GuyBernard	1
JunRao	ChristianGarcia-Arellano	1
MassimoMecella	LucaDeSantis	1
MassimoMecella	EduardoMena	1
MaxJ.Egenhofer	BettySalzberg	1
LeanYu	KinKeungLai	2
SouravChakraborty	KeWang	1
ThomasReichherzer	FilippoMenczer	1
ShuichengYan	JunYan	3
ShaorongLiu	QinghuaZou	1
ZhaohuiWu	BaoyanLiu	1
MoustafaA.Hammad	MohamedY.Eltabakh	1
HansChalupsky	DunjaMladenic	1
WeiWang0010	KarlStrohmaier	1
AshwinMachanavajjhala	AdinaCrainiceanu	1
SamLightstone	BishwaranjanBhattacharjee	1
LiangJin	ChenLi	1
HungSonNguyen	ChiLangNgo	1
ZacharyG.Ives	BertramLud*scher	1
ThomasSeidl	MatthiasHampel	1
GregPape	DavidClutter	1
ZhihuaSu	DongqingYang	1
SteffenStaab	F*lixSaltor	1
Mi-YenYeh	Jen-WeiHuang	1
ElisaBertino	AnnaMaddalena	1
LouiqaRaschid	FelixNaumann	1
RobertF.Murphy	AmbujK.Singh	1
IhabF.Ilyas	AhmedK.Elmagarmid	2
WeiWang0010	JinzeLiu	2
RameshJain	PilhoKim	1
SamMardanbeigi	BrentN.Chun	1
GeorgeOstrouchov	Byung-HoonPark	1
KinjiOno	Fr*d*ricAndr*s	1
YimingMa	SharadMehrotra	2
YifanLi	JiaweiHan	1
Zo*Lacroix	JulienVinel	1
GeneTsudik	EinarMykletun	1
YuchangLu	Chun-YiShi	1
JingHu	HengTaoShen	1
R.ScottCost	LiDing	1
PatrickBlair	DavidHandy	1
MartinKlein	KunLiu	1
KinKeungLai	JichangDong	1
RobertCunningham	OliverDain	1
VasiliVasiliZolotov	ShankarPal	1
JunFang	AlazelAcheson	1
ZhiyongShen	Yi-DongShen	1
TheodoreJohnson	FlipKorn	1
MarcoMesiti	IoanaManolescu	1
SandeepGupta	ChinyaV.Ravishankar	1
YanFu	WenGao	1
GeorgiosPapadopoulos0002	BirgittaK*nig-Ries	1
OuriWolfson	NimeshNedungadi	1
JussiKangasharju	AlejandroP.Buchmann	1
Shi-MingZhang	QiangYang	1
ErikThomsen	DavidBernholz	1
Ming-SyanChen	Chih-MingHsu	1
RalfSchenkel	MartinTheobald	1
Zolt*nGy*ngyi	JanO.Pedersen	1
PrasannaGanesan	GaganAggarwal	1
StefanieScherzinger	NicoleSchweikardt	2
GuyM.Lohman	AlanHalverson	1
JiriSchindler	GregoryR.Ganger	1
MichaelWelge	LorettaAuvil	1
YuePan	TaoLiu	1
LeonardJ.Seligman	ArnonRosenthal	1
SurajitChaudhuri	LuisGravano	1
StefanBrecheisen	MaximilianViermetz	1
Eun-KyuLee	Byoung-WooOh	1
NanWang0002	LiangyouChen	1
Wei-YingMa	TaoLiu	1
YuqiangGuan	BrianKulis	1
St*phaneGan*arski	PascalMolli	1
YehoshuaSagiv	YaronKanza	1
NatasaMilic-Frayling	JafarAdibi	1
ShinyaKitaguchi	KazuyaOkamoto	1
SeikyungJung	KevinHarris	1
MikeHanlon	JohannesKlein	1
YasushiSakurai	ToshiyukiAmagasa	1
RobertoJ.BayardoJr.	ChristosFaloutsos	1
XiaodongLin	JeromeP.Reiter	1
WilfredNg	DikLunLee	2
AlexanderV.Lotov	AlexanderD.Zaitsev	1
Min-SooKim0001	Eun-KyuLee	1
HonghuaDai	DanWei	1
VasiliVasiliZolotov	IstvanCseri	1
SurajitChaudhuri	RavishankarRamamurthy	1
TomoyukiUchida	HiroakiUeda	1
RaghuRamakrishnan	DavidJ.DeWitt	1
KennethP.Smith	GlennS.Iwerks	1
EbruErsan	BalajiRathakrishnan	1
VasileiosMegalooikonomou	QiangWang	1
SudiptoGuha	KyuseokShim	2
GuyM.Lohman	AshrafAboulnaga	1
TetsuyaIshikawa	AtsushiFujii	1
AmrElAbbadi	AbhishekGupta	1
MenahemFriedman	AbrahamKandel	1
ShankarPal	ElizabethJ.O'Neil	1
WeiWang	SamuelMadden	1
TomZylkin	GregoryE.Gonye	1
MaartendeRijke	JaapKamps	1
RobertoEsposito	MaristellaMatera	1
QianShengCheng	JunYan	1
VipulKashyap	TizianaCatarci	1
SachindraJoshi	NeerajAgrawal	1
QiangYang	FengshanBai	1
RameshJain	AmarnathGupta	1
TimothyW.Finin	JoelSachs	1
EdmondHaoCunWu	AndyM.Yip	1
MarcoBrambilla	IoanaManolescu	1
YufeiTao	KyriakosMouratidis	1
MichaelKuperberg	DanA.Simovici	1
VishalDoshi	RongPan	1
DamianosChatziantoniou	AchilleasAnagnostopoulos	1
MasonBendixen	Jos*A.Blakeley	1
PeterA.Flach	NicolasLachiche	1
LiDing	JoelSachs	1
Jia-YuPan	HiroyukiKitagawa	1
JohnW.Byers	JeffreyConsidine	1
RichardR.Muntz	PhilipS.Yu	1
WenGao	RuixiangSun	1
Xiao-DongLiu	Hai-YanLiu	1
RajeevMotwani	HectorGarcia-Molina	2
VincentShin-MuTseng	Ching-PinKao	1
OmarBenjelloun	IoanaManolescu	1
Chang-RongLin	ArbeeL.P.Chen	1
YanHuang	XiaobinMa	1
MuralidharKrishnaprasad	AnandManikutty	1
JohannesGehrke	AshwinMachanavajjhala	1
VenugopalGovindaraju	FaisalFarooq	1
Chung-WenCho	ArbeeL.P.Chen	1
AndrewWitkowski	AbhinavGupta	1
MarianneWinslett	JohnNorris	1
KarinKailing	ClaudiaPlant	1
ZhuoChen	MengchiLiu	1
DavidGa**n	CarlosBeltr*n	1
SharadMehrotra	KemalAltintas	1
JohannesGehrke	AdinaCrainiceanu	1
ThemistoklisPalpanas	EamonnJ.Keogh	1
YiPeng	GangKou	1
UmaMahadevan	D.Sivakumar	1
XibeiJia	ArekKasprzyk	1
YannisTheodoridis	IreneNtoutsi	1
ElkeA.Rundensteiner	BradfordPielech	1
WeiWang0010	DineshManocha	1
ZhengChen	Jian-TaoSun	1
ScottRenner	ArnonRosenthal	1
RichardT.Snodgrass	CurtisE.Dyreson	1
IvanPopivanov	GuyM.Lohman	1
YeHuang	PaulJ.McCullagh	1
MinglongShao	AnastassiaAilamaki	1
WeiguoFan	QiangYang	1
VictorM.Markowitz	MikeTyers	1
Jean-YvesGarinet	AbdelkaderB*tari	1
Wei-YingMa	QianShengCheng	1
RongJin	FengKang	1
TatianaSemenova	MarkusHegland	1
ChenyongHu	BenyuZhang	1
GeorgeKollios	DimitrisPapadias	1
TakashiWashio	PhuChienNguyen	1
ShanWang	CuipingLi	1
SurajitChaudhuri	NicolasBruno	1
YonghuaWu	EinarMykletun	1
R.ScottCost	PavanReddivari	1
MartinMozina	JanezDemsar	1
M.NedimAlpdemir	ArijitMukherjee	1
Ren*eJ.Miller	ArielFuxman	1
Ren*eJ.Miller	JohnMylopoulos	1
TheodoreJohnson	GrahamCormode	1
StefanoSpaccapietra	ErichJ.Neuhold	1
FotoN.Afrati	ChenLi	1
RamaswamyHariharan	AmnonMeyers	1
AmrElAbbadi	AhmedMetwally	1
H.V.Jagadish	EvanW.Steeg	1
VarunKacholia	NingZhang0002	1
SophieChabridon	JeanFerri*	1
SurajitChaudhuri	RameshBhashyam	1
VasiliyMalakhov	ImadRahal	1
JeffreyXuYu	HongjunLu	5
StefanoRizzi	MaurizioMazza	1
WonminSong	SooyongPark	1
PeterCarlin	Jos*A.Blakeley	1
ZhengChen	WeiguoFan	2
JinqiangHan	DongqingYang	1
Hua-JunZeng	DouShen	2
GerhardWeikum	AlonY.Halevy	1
VipulKashyap	ArantzaIllarramendi	1
MehulA.Shah	JosephM.Hellerstein	1
ZhanhuaiLi	KebinCui	1
RongJin	Pang-NingTan	1
WeiLi	AriMozes	1
Per-*keLarson	JingrenZhou	1
ErickCant*-Paz	ChandrikaKamath	1
Wen-ChiChou	Kuen-PinWu	1
JudithA.Blake	JananT.Eppig	1
KeechulJung	EunYiKim	1
SergeAbiteboul	IriniFundulaki	1
PieroFraternali	MarcoBrambilla	1
StefanoSpaccapietra	OlgaDeTroyer	1
Ren*eJ.Miller	AnastasiosKementsietsidis	1
ZhengChen	WensiXi	4
WeiHong	SamuelMadden	2
RamachandranVenkatesh	Jos*A.Blakeley	1
RachidGuerraoui	ClaudiaRoncancio	1
ChristianKleinerman	BalajiRathakrishnan	1
NagizaF.Samatova	GeorgeOstrouchov	1
SoumenChakrabarti	ShantanuGodbole	2
PhuChienNguyen	HiroshiMotoda	1
YirongXu	RaghuRamakrishnan	1
KeshengWu	ArieShoshani	1
XiaoweiJiang	BalajiRathakrishnan	1
OlgaDeTroyer	MassimoMecella	1
WeiyunHuang	EdwardOmiecinski	1
PrasannaGanesan	MayankBawa	2
TorstenGrust	SabineMayer	1
Shyh-KweiChen	Kun-LungWu	1
DonghyunKim	BongheeHong	1
OlgaDeTroyer	LucaDeSantis	1
JenniferWidom	AnastassiaAilamaki	1
SteffenStaab	LucaDeSantis	1
RiccardoOrtale	GiuseppeManco	1
RiccardoTorlone	PaoloAtzeni	1
PradeepB.Teregowda	HuiHan	1
Zheng-YuNiu	ChewLimTan	1
KenichiYoshida	HiroshiMotoda	1
EstherRyvkina	ArvindArasu	1
RamaswamyHariharan	CharlesHuyck	1
Zo*Lacroix	GeraldMoeller	1
MohamedY.Eltabakh	AhmedK.Elmagarmid	1
YounghwanLim	DongyeopRyu	1
TianyiJiang	AlexanderTuzhilin	1
LinanJiang	JingShan	1
TokWangLing	QiHe	1
SunilPrabhakar	MoustafaA.Hammad	1
LetiziaTanca	ElenaBaralis	1
Wei-YingMa	FrederickH.Lochovsky	1
ShariqRizvi	S.Sudarshan	1
IlvioBruder	HolgerMeyer	1
MasafumiHamamoto	HiroyukiKitagawa	1
TimothyRoscoe	JosephM.Hellerstein	1
StefanBrecheisen	PeerKr*ger	2
MehulA.Shah	EricA.Brewer	1
RobertJ.Plemmons	MichaelW.Berry	1
MohamedZiauddin	Beno*tDageville	1
OlafHoos	AlfredUltsch	1
KarimBa*na	Hye-YoungPaik	1
DonghuiZhang	BettySalzberg	1
ChiangLee	Chao-ChunChen	1
MarkScardina	K.Karun	1
PrakashLinga	JayavelShanmugasundaram	1
TaoTao	KevinChen-ChuanChang	2
TovaMilo	SergeAbiteboul	2
VipinKumar	AyselOzgur	1
PeerKr*ger	ChristianBaumgartner	1
Mohand-SaidHacid	Hye-YoungPaik	1
LyleH.Ungar	AlexandrinPopescul	1
RobertJ.Plemmons	FarialShahnaz	1
ShawnD.Newsam	ErickCant*-Paz	1
PremMelville	MaytalSaar-Tsechansky	1
XiaofengMeng	TokWangLing	1
TuBaoHo	MaoSongLin	1
MichaelUschold	MichaelGr*ninger	1
JosephM.Hellerstein	EricA.Brewer	1
NagaK.Govindaraju	DineshManocha	1
PhilippePucheral	ClaudiaRoncancio	1
YuqingWu	SteliosPaparizos	1
TaoLiu	GongyiWu	1
KeithMarsolo	DmitriiPolshakov	1
LaurentMignet	AlbertoO.Mendelzon	1
KatsuyukiYamazaki	HiroshiMotoda	1
MaxJ.Egenhofer	JohnF.Roddick	1
QiangYang	ChunliWang	1
WeiWang0010	BrandonLloyd	1
Shin-MuTseng	Chien-ILee	1
ShouyangWang	JichangDong	1
WeiguoFan	EdwardA.Fox	1
YirongXu	VukErcegovac	1
HaofengZhou	BaileShi	2
RajeevMotwani	KrishnaramKenthapadi	1
BijitHore	BalakrishnaR.Iyer	1
RaghuRamakrishnan	JeffreyF.Naughton	2
WonminSong	Song-YiYi	1
IsaacG.Councill	C.LeeGiles	1
Zo*Lacroix	OmarBoucelma	1
TetsuhiroMiyahara	HiroakiUeda	1
Wang-ChienLee	BaihuaZheng	2
PaulBrown	IhabF.Ilyas	1
HaimKaplan	EdithCohen	1
YiSun	PeterTi*o	1
WilliamO'Connell	RameshBhashyam	1
JessicaLin	DonnaM.Nystrom	2
TengjiaoWang	JinqiangHan	1
NataliaL*pez	ManuelN**ez	1
MotiSchneider	AbrahamKandel	1
YasushiSakurai	MasashiMorimoto	1
MohammedJaveedZaki	IsidoreRigoutsos	1
Lien-FaLin	ChiangLee	1
SurajitChaudhuri	Beno*tDageville	1
WynneHsu	ChaoChen	1
R.ScottCost	AnupamJoshi	1
HuaLi	BenyuZhang	1
SamuelMadden	IsabelF.Cruz	1
ThemisPalpanas	MarcCardle	1
HongyuanLi	DmitriiPolshakov	1
YannisTheodoridis	IgorNaiFovino	1
MaximilianViermetz	MartinPfeifle	1
LucaDeSantis	ArisM.Ouksel	1
Zheng(Jessica)Zhao	LaksV.S.Lakshmanan	1
JingHu	CuiYu	1
HuipingCao	DavidW.Cheung	2
KotagiriRamamohanarao	HongjianFan	1
MartinRingwald	CarolJ.Bult	1
MoustafaA.Hammad	AnnChristineCatlin	1
PeterKemper	PeterBuchholz	1
LucyChernobrod	DieterGawlick	1
JenniferT.Chayes	ChristianBorgs	1
WalidG.Aref	RahulShah	2
RaghuKrishnapuram	NeerajAgrawal	1
ThomasNeumann	GuidoMoerkotte	2
XinJin	BamshadMobasher	1
ShengMa	CarlottaDomeniconi	1
XiaopengXiong	RobertGwadera	1
WeiyiMeng	ClementT.Yu	1
GideonSchaller	ElizabethJ.O'Neil	1
Yi-HungWu	Ding-YingChiu	1
WeiwenYang	SharadMehrotra	1
ZidongWang	KarlFraser	1
TheodoreJohnson	OliverSpatscheck	1
OliverSpatscheck	GrahamCormode	1
Wei-YingMa	DouShen	2
ShankarKrishnan	DavidS.Johnson	1
Jin-yiCai	JamesJ.Schauer	1
YukWahWong	SudhirVerma	1
MartinKlein	JamesDull	1
TakahiraYamaguchi	ShinyaKitaguchi	1
KonstantinaStoupa	IoannisTsoukalas	1
PrasannaGanesan	NinaMishra	1
KedarDhamdhere	ChristopherOlston	1
YuqiangGuan	InderjitS.Dhillon	2
WesleyW.Terpstra	JussiKangasharju	1
TaoLiu	LiMa	1
IsmailcemBudakArpinar	AmitP.Sheth	1
SridharRajagopalan	BeverlyYang	1
ZhihuaWang	AlbertoLerner	1
JaroslavPokorn*	AthenaVakali	1
QimingHuang	MichaelK.Ng	1
GaganAggarwal	DilysThomas	1
ZhengChen	YongYu	3
Kam-yiuLam	HenryChi-WaiPang	1
YongShi	XiaowoTang	1
DiveshSrivastava	AmitMarathe	2
ShivnathBabu	ItaruNishizawa	1
ChenWang	BaileShi	3
JialieShen	DuQ.Huynh	1
RobertoTagliaferri	LaraDeVinco	1
SurajitChaudhuri	SanjayAgrawal	1
YiChen	RajeshBordawekar	1
SergeAbiteboul	BogdanAlexe	1
RubenH.Zamar	JamesChilson	1
NagizaF.Samatova	Byung-HoonPark	1
Mohand-SaidHacid	MassimoMecella	1
YaZhang	XiangJi	1
VipulKashyap	F*lixSaltor	1
SteliosPaparizos	LaksV.S.Lakshmanan	1
MasonBendixen	HonggangZhang	1
SilviaNittel	KelvinT.Leung	1
ScottShenker	JosephM.Hellerstein	2
ShuaiMa	ShiweiTang	2
XinDong	EmaNemes	1
YannisVelegrakis	JohnMylopoulos	1
PaoloGarza	LetiziaTanca	1
RobertoAmato	DiegodiBernardo	1
BongheeHong	BonggiJun	1
SameepMehta	KeithMarsolo	1
OdedShmueli	MukundRaghavachari	1
WenGao	JunfaLiu	1
HakanHacig*m*s	BalakrishnaR.Iyer	2
Kian-LeeTan	BengChinOoi	4
Jae-ChulSir	Eun-YoungKim	1
TimChurches	PeterChristen	2
GeorgeSamaras	GeorgeLoizou	1
KonstantinaStoupa	AthenaVakali	1
PhilippeCudr*-Mauroux	KarlAberer	1
QiangYang	JoshuaZhexueHuang	1
YounghwanLim	MariaHong	2
PhilippObreiter	GeorgiosPapadopoulos0002	1
JianPei	ChenWang	2
LingChen	JinFan	1
JiyingWang	Ji-RongWen	1
YannisSismanis	NickRoussopoulos	1
MohamedZiauddin	MohamedZa*t	1
GaoCong	FengPan	2
Y.DoraCai	GregPape	1
MaximilianViermetz	MarcoP*tke	1
MuneakiOhshima	JiajinHuang	1
VolkerMarkl	HamidPirahesh	2
RenuKurienBostwick	GaryKratkiewicz	1
PadhraicSmyth	MarkSteyvers	1
HamidPirahesh	BertholdReinwald	1
JohnF.Roddick	DimitrisPapadias	1
TomazCurk	BlazZupan	1
VukErcegovac	RaghuRamakrishnan	1
PeriklisAndritsos	PanayiotisTsaparas	2
WilliamH.Piel	KatherineG.Herbert	1
VassilKriakov	AlexDelis	1
NikosMamoulis	DavidW.Cheung	3
RaymondJ.Mooney	ArindamBanerjee	1
SamuelMadden	MaxJ.Egenhofer	1
SandeepGopisetty	JaiMenon	1
YehoshuaSagiv	EliyahuSafra	1
UlrichMeissen	TjarkWahnfried	1
WangChiewTan	LauraChiticariu	1
J.WennyRahayu	CarloWouters	1
WilliamH.Piel	JasonTsong-LiWang	1
XiaoleiLi	HectorGonzalez	1
ZhengChen	YuchangLu	1
StanleyR.M.Oliveira	OsmarR.Za*ane	1
TerumasaAoki	HiroshiYasuda	1
HonghuaDai	GangLi	4
QiZhong	JiaLi	1
ShenghuoZhu	DavidSelinger	1
VasilisVassalos	MinosN.Garofalakis	1
Jia-YuPan	ChristosFaloutsos	3
SharadMehrotra	HaiminLee	1
DennisShasha	AlbertoLerner	1
PhilippePucheral	PatrickValduriez	1
GordonV.Cormack	CharlesL.A.Clarke	1
SureshVenkatasubramanian	SubodhKumar	1
SeikyungJung	JonathanL.Herlocker	1
MichaelGertz	Kai-UweSattler	1
JonathanL.Herlocker	JanetWebster	1
RobertoJ.BayardoJr.	RakeshAgrawal	1
NarenRamakrishnan	MalcolmPotts	1
DoloresRomeroMorales	BelenMartin-Barragan	1
QiongLuo	DikLunLee	1
HiroshiMotoda	AmitMandvikar	1
RicardoJ.G.B.Campello	EduardoR.Hruschka	1
StefanoSpaccapietra	LucaDeSantis	1
IoanaManolescu	GeorgeA.Mihaila	1
SanjayChawla	JosephG.Davis	1
YouxuanJin	SamSkrivan	1
PhilippePucheral	G*r*meCanals	1
ZacharyG.Ives	MichaelJ.Franklin	1
WeihuaWu	AmalPerera	1
NingLiu	JunYan	1
LupingDing	GeorgeT.Heineman	1
YuxinChen	BaopingZhang	1
MaytalSaar-Tsechansky	FosterJ.Provost	1
TimothyM.Sutherland	ElkeA.Rundensteiner	1
NicoletaPreda	IoanaManolescu	1
KunLiu	JamesDull	1
JeffreyF.Naughton	CurtJ.Ellmann	1
HakanHacig*m*s	BijitHore	1
WeiWang0011	JeffreyXuYu	1
Shui-LungChuang	Chien-ChungHuang	1
GuyM.Lohman	DanielC.Zilio	1
ThomasHernandez	SubbaraoKambhampati	1
WilliamPerrizo	KirkScott	1
YongtaiZhu	JianPei	1
WenfeiFan	PhilipBohannon	1
MariaHong	JaeGakHwang	1
XingzhiSun	MariaE.Orlowska	1
AnHaiDoan	AlonY.Halevy	3
PeerKr*ger	MarcoP*tke	1
PeterCarlin	HonggangZhang	1
YuanWang	DavidJ.DeWitt	1
MariosHadjieleftheriou	HuipingCao	1
PanosM.Pardalos	CheongHeePark	1
XinDong	JayantMadhavan	2
VolkerMarkl	PeterJ.Haas	3
PatrickBlair	KakaliSarkar	1
NaokiAbe	ChidanandApt*	1
InderjitS.Dhillon	DharmendraS.Modha	1
RahulShah	MohamedF.Mokbel	1
NidalM.Zeidat	ChristophF.Eick	1
KinjiOno	J*r*meGodard	1
JehanWickramasuriya	HaiminLee	1
YonghongPeng	FadiA.Thabtah	1
YuxinChen	MarcosAndr*Gon*alves	1
ArielFuxman	AnastasiosKementsietsidis	1
MichaelBiwer	MartinTheobald	1
WensiXi	WeiguoFan	2
MarceloArenas	LaurentMignet	1
DimitarFilev	AlanClark	1
XueLi	MariaE.Orlowska	1
WangChiewTan	DeepavaliBhagwat	1
MichaelPowers	KakaliSarkar	1
XiaoyongChai	QiangYang	1
ZacharyG.Ives	JenniferWidom	1
PeterGatalsky	NataliaV.Andrienko	1
NickP.Clarke	BasimA.Majeed	1
YuXu	AlinDeutsch	2
JunRao	CalistoZuzarte	1
RakeshAgrawal	KristenLeFevre	2
HonggangZhang	GideonSchaller	1
PhilippAnokhin	AmihaiMotro	1
RachidGuerraoui	BrunoDefude	1
YipingZhan	ChristosFaloutsos	1
SougataMukherjea	BhuvanBamba	1
MichihiroKuramochi	GeorgeKarypis	2
KarlAberer	FabiusKlemm	1
ZhengChen	TaoLiu	1
FlorianWaas	C*sarA.Galindo-Legaria	1
MasonBendixen	ChristianKleinerman	1
MunirCochinwala	DavidRosenbluth	1
JosephG.Davis	GauravPandey	1
JignashuParikh	ByronDom	1
Zo*Lacroix	YingGuangLi	1
NicolasSpyratos	GeorgeLoizou	1
MarvinB.L.Tan	AngelaGoh	1
RaymondT.Ng	BengChinOoi	1
RobertaCochrane	HamidPirahesh	1
FaroukToumani	ChristopheRey	2
SeanC.Rhea	BoonThauLoo	1
MatthiasBender	JensGraupmann	1
FeiPan	AmalPerera	1
QiangDing	DongmeiRen	1
TaehoJo	NathalieJapkowicz	1
MohamedZiauddin	KhaledYagoub	1
MartinEster	JiaweiHan	1
MichaelWelge	JiaweiHan	1
RuchitaBhargava	PatrickBlair	1
YongYu	WeiguoFan	1
YongtaiZhu	BaileShi	1
KarinKailing	Hans-PeterKriegel	6
SharadMehrotra	IosifLazaridis	2
TheodoreDalamagas	Klaas-JanWinkel	1
NicoletaPreda	BogdanCautis	1
YiqingTu	HonghuaDai	1
CemilAlper	*zg*rUlusoy	1
VipulKashyap	ErichJ.Neuhold	1
SrinivasanParthasarathy	AdrianoVeloso	1
XiaohuaHu	AnnPrestrud	1
ImadRahal	DongmeiRen	2
QiangYang	MichaelK.Ng	1
SusanB.Davidson	MikeTyers	1
NileshN.Dalvi	DanSuciu	1
IlvioBruder	BirgerH*nsel	1
YoshifumiMasunaga	KatsumiTanaka	1
ShaochuanCheng	KanliangWang	1
MathiasM*rschel	HamidPirahesh	1
ToddC.Mowry	AnastassiaAilamaki	1
PierreGeurts	GuyLeduc	1
HeikkiMannila	FlorisGeerts	1
RajeevMotwani	MayurDatar	1
MichaelStonebraker	MagdalenaBalazinska	1
IoanaManolescu	BogdanCautis	1
YihongDing	DavidW.Embley	1
GuyBernard	G*r*meCanals	1
GianlucaLax	FrancescoBuccafurri	1
RaymondT.Ng	ChulyunKim	1
YaliZhu	NishantMehta	1
SriramPadmanabhan	OdedShmueli	1
IlKonKim	Byung-JooKim	2
ToruTakaki	TetsuyaIshikawa	1
RobertoAmato	LaraDeVinco	1
TokWangLing	MengchiLiu	1
SubramanianArumugam	ChrisJermaine	1
SihemAmer-Yahia	JayavelShanmugasundaram	1
HonggaLi	BoHuang	1
JiyeLi	BinTang	1
PulyamonVihakapirom	PaulMason	1
YanChen	HaixunWang	1
YutaoShou	XinZhang	1
ZhenyuLiu	JunghooCho	1
RaghuRamakrishnan	Per-*keLarson	2
HaiminLee	CarterButts	1
KarlAberer	ErichJ.Neuhold	1
RonHutchison	MarcAnderson	1
KatsuyukiYamazaki	FuminoriAdachi	1
Tzong-HanTsai	Kuen-PinWu	1
XiaochunYang	ChenLi	1
IlvioBruder	AndreasHeuer	1
MohamedZa*t	KhaledYagoub	1
IoannisTsoukalas	AthenaVakali	1
SavithaSrinivasan	PrasadM.Deshpande	2
HongyuGuo	HernaL.Viktor	1
XiaoweiJiang	HonggangZhang	1
XueminLin	XiaofangZhou	1
PaoloManghi	GiovanniConforti	1
PeterI.Cowling	FadiA.Thabtah	1
MariaHong	Jae-ChulSir	1
HongjunLu	AoyingZhou	1
ManojSyamala	LuborKoll*r	1
JoydeepGhosh	DharmendraS.Modha	1
Wei-YingMa	RuihuaSong	1
NinaMishra	HectorGarcia-Molina	1
SameepMehta	HuiYang	2
RayidGhani	AndrewE.Fano	1
KatherineG.Herbert	JasonTsong-LiWang	1
RuchitaBhargava	MichaelPowers	1
RamnathBalasubramanyan	JignashuParikh	1
VictorB.Zordan	MarcCardle	1
MasaruKitsuregawa	AnirbanMondal	1
Young-GabKim	Dae-HaPark	1
TorstenGrust	SherifSakr	1
Doo-KwonBaik	Chang-JooMoon	1
ShivnathBabu	JenniferWidom	2
YugyungLee	JamesGeller	1
SrinivasanParthasarathy	BenjaminRutt	1
VivekBhatnagar	HuiHan	1
ThomasRisse	PhilippeCudr*-Mauroux	1
Wen-LianHsu	Ting-YiSung	1
SamuelMadden	DanielJ.Abadi	1
MehdiEssid	JulienVinel	1
ShengMa	MitsunoriOgihara	1
RobertNichol	AndrewW.Moore	1
JunjieGuo	CalistoZuzarte	1
Y*celSaygin	LoredanaParasilitiProvenza	1
JayantR.Haritsa	AbhijitKadlag	2
Tzong-HanTsai	Ting-YiSung	1
YuxinChen	EdwardA.Fox	1
PavanKumarC.Singitham	MahathiS.Mahabhashyam	1
BingLiu	AndreasSchaller	1
MilesTrochesset	AnthonyJ.Bonner	1
ShojiroNishio	NorishigeMurakami	1
ThanaaM.Ghanem	MohamedF.Mokbel	2
EamonnJ.Keogh	DonnaM.Nystrom	2
TomonariMasada	JunAdachi	1
StevenW.Schlosser	GregoryR.Ganger	1
ChengyuSun	AmrElAbbadi	1
YiLifu	AnirbanMondal	1
ShawnBowers	LoisM.L.Delcambre	1
JaehoKang	Hyuk-ChulKwon	1
NicolaOnose	J*r*meSim*on	1
IbtissamElKhayat	GuyLeduc	1
J*rgenKr*mer	BernhardSeeger	1
YufeiTao	BinLiu0002	2
KrishnaramKenthapadi	JenniferWidom	1
RobertoAmato	GiuseppeLongo	1
SimingHuang	GuoliangYang	1
XiaopengXiong	MohamedH.Ali	1
XuanZhou	HweeHwaPang	1
MaxJ.Egenhofer	AlexandrosLabrinidis	1
SlawomirStaworko	JerzyMarcinkowski	2
EmilioCarrizosa	DoloresRomeroMorales	1
PengLiu	BoLuo	1
WalidG.Aref	MohamedY.Eltabakh	1
YannisKotidis	SihemAmer-Yahia	1
Pang-NingTan	HuiXiong	3
RajeevMotwani	PrasannaGanesan	1
MarcoMesiti	BhavaniM.Thuraisingham	1
XinXu	EibeFrank	1
FabianM*rchen	AlfredUltsch	1
SanjayAgrawal	LuborKoll*r	1
FilippoMenczer	AnaGabrielaMaguitman	1
YouxuanJin	AdamYeh	1
KenichiYoshida	AkihiroNakashima	1
Wei-YingMa	Chun-YiShi	1
CuiZhu	ChristosFaloutsos	1
ZhengqingTang	ZetaoYan	1
FeifeiLi	DimitrisPapadias	1
JiaweiHan	HongCheng	1
MohamedF.Mokbel	MiretteS.Marzouk	1
StefanSigg	AchimKraiss	1
MikeTyers	EvanW.Steeg	1
TerriK.Attwood	PaulBradley	1
OsmarR.Za*ane	JiaLi	1
WeiHong	EugeneWu0002	1
SamLightstone	GuyM.Lohman	2
AnthonyStefanidis	AlexandrosLabrinidis	1
YuGuoWang	YiChen	1
SrinivasanParthasarathy	HongyuanLi	1
MichaelWelge	DavidClutter	1
ChristopherBesemann	AjayYekkirala	1
MayankBawa	AristidesGionis	1
PascalMolli	LucBouganim	1
SamuelMadden	AnthonyStefanidis	1
ErnestTeniente	CarlesFarr*	1
MohamedF.Mokbel	AnnChristineCatlin	1
KarlAberer	ArisM.Ouksel	1
SurajitChaudhuri	GerhardWeikum	1
ChristopheRey	AgnieszkaRutkowska	1
OmerZaafrany	MotiSchneider	1
MohamedZiauddin	KarlDias	1
ThomasM.Tirpak	BingLiu	1
RamachandranVenkatesh	MasonBendixen	1
ShashiShekhar	HuiXiong	2
SusanKotsovolos	MuralidharKrishnaprasad	1
WalidRjaibi	PaulBird	1
KunLiu	DavidHandy	1
KonstantinaStoupa	FangLi	1
AndreasHeuer	AndreZeitz	1
VictorM.Markowitz	ThodorosTopaloglou	1
JianPei	FaisalFarooq	1
StephenJ.Wright	DeborahS.Gross	1
StratosPaulakis	MagdaliniEirinaki	1
PeterChristen	MarkusHegland	1
StevePoteet	AnneKao	1
YoonguKim	SeogPark	1
PhilippObreiter	BirgittaK*nig-Ries	1
ScottShenker	BrentN.Chun	1
Wai-ShingHo	BenKao	1
RubenH.Zamar	RaymondT.Ng	1
GiovannaGuerrini	ElisaBertino	1
NicolasLachiche	Jos*Hern*ndez-Orallo	1
JulienVinel	AbdelkaderB*tari	1
RalfRantzau	RakeshAgrawal	1
MohammedJaveedZaki	BartGoethals	1
VenkatKrishnamurthy	SridharRamachandran	1
TimosK.Sellis	TaoCheng	1
YingXu0002	GaganAggarwal	1
PieroFraternali	MarcoDario	1
UlrichG*ntzer	JasonXinZheng	1
XiaofengMeng	TingChen	1
HolgerMeyer	AndreasHeuer	1
MingshengHong	ChenWang	1
YannisTheodoridis	PaoloCiaccia	1
RaviJanardan	HaesunPark	1
MichaelWelge	GregPape	1
JianfeiZhu	G*staGrahne	1
ZhihongChong	AoyingZhou	1
FengPan	AnthonyK.H.Tung	2
IriniFundulaki	ArnaudSahuguet	3
DharmendraS.Modha	ChristosFaloutsos	1
StevenMinton	KristinaLerman	1
DharmendraS.Modha	DeepayanChakrabarti	1
UgurG*d*kbay	CemilAlper	1
PhilippePucheral	PatriciaSerrano-Alvarado	1
SteffenStaab	MonicaScannapieco	1
XiaoyongChai	DikLunLee	2
DesmondJ.Fitzgerald	AlvaroA.A.Fernandes	1
PhilippeCudr*-Mauroux	MassimoMecella	1
DavidMaier	BillHowe	1
YaoLiu	SamYuanSung	2
KevinKeenoy	GiorgosKokkinidis	1
SamuelBushra	JamesDull	1
RonKohavi	RajeshParekh	1
LeoMark	EdwardOmiecinski	1
VladimirZbarsky	SavithaSrinivasan	1
XiaCao	BengChinOoi	1
TorstenGrust	JensTeubner	2
PatrickValduriez	LucBouganim	1
PaoloCiaccia	IlariaBartolini	1
SpirosPapadimitriou	DharmendraS.Modha	1
WilliamS.Yerazunis	ChristianSiefkes	2
RaymondT.Ng	LeiChen0002	1
WenQiangWang	ElisaBertino	1
HengTaoShen	BengChinOoi	1
YanFu	JunfaLiu	1
Kian-LeeTan	GaoCong	3
ToniUrp*	ErnestTeniente	1
TatsuyaAkutsu	HiroshiMamitsuka	1
SubodhKumar	DavidS.Johnson	1
JianXu	JeffreyXuYu	1
ClaudiaBauzerMedeiros	Andr*Santanch*	1
TizianaCatarci	PhilippeCudr*-Mauroux	1
JianyongWang	GeorgeKarypis	3
JussiMyllymaki	FengTian	1
MartinRingwald	JudithA.Blake	1
StefanoSpaccapietra	MonicaScannapieco	1
LaraDeVinco	CiroDonalek	1
EugeneJ.Shekita	AndreasNeumann	1
XiaopengXiong	AhmedK.Elmagarmid	1
NingAn	KothuriVenkataRaviKanth	1
VikasArora	SusanKotsovolos	1
YingYang	XingquanZhu	2
HongYao	CoryJ.Butz	1
SanjayChawla	GauravPandey	1
YanChen	SanjayKumarMadria	1
JunYang0001	AdamSilberstein	1
IanDavidson	AshishGrover	1
HuaLu	BoHuang	1
TimothyRoscoe	SeanC.Rhea	1
SandeepPandey	ChristopherOlston	1
GregoryR.Ganger	AnastassiaAilamaki	1
RamachandranVenkatesh	BeysimSezgin	1
TerriK.Attwood	AlexMitchell	1
YunyaoLi	CongYu	1
SamuelBushra	MiteshVasa	1
ScottShenker	BoonThauLoo	2
SankarSubramanian	AndrewWitkowski	1
MiteshPatel	BinHe	1
ValterCrescenzi	PaoloMissier	1
ZhengdaoXu	Hans-ArnoJacobsen	1
ToddOlsen	ChrisGiannella	1
WeiguoFan	ShuichengYan	1
XingboYu	IosifLazaridis	1
YutakaKidawara	KatsumiTanaka	1
SteffenStaab	RudiStuder	1
RajeevMotwani	AristidesGionis	1
NingLiu	FengshanBai	1
YirongXu	JerryKiernan	2
MuraliRamanathan	JianPei	1
JeffreyXuYu	GabrielPuiCheongFung	1
WolfgangLehner	HenrikeBerthold	1
JamesW.Warner	AnandManikutty	1
KaladharVoruganti	JaiMenon	1
YannisVelegrakis	ArielFuxman	1
TaoLin	ChristofBornh*vd	1
IraCohen	GeorgeForman	1
DongweiCao	DanielBoley	1
YunChi	RichardR.Muntz	2
OmarBenjelloun	BogdanAlexe	1
QiLi	JiepingYe	2
GiovanniB.Marchisio	CarstenTusk	1
SharadMehrotra	JehanWickramasuriya	1
MaxJ.Egenhofer	DimitrisPapadias	1
JohannesKlein	Hansj*rgZeller	1
IliasNitsos	GeorgiosEvangelidis	1
NataliaVanetik	EhudGudes	1
NicolasLachiche	C*sarFerri	1
MalcolmPotts	BudMishra	1
NobuhisaUeda	AtsukoYamaguchi	1
NingZhang0002	M.Tamer*zsu	1
MatthiasSchubert	AlexeyPryakhin	2
PeriklisAndritsos	ArielFuxman	1
XibeiJia	ByronChoi	1
MingshengHong	BaileShi	1
DavidWai-LokCheung	ChiLapYip	1
UlrichR*ckert	LotharRichter	1
DongmeiRen	AmalPerera	1
WensiXi	HuaLi	1
TsuyoshiId*	HisashiKashima	1
JunHuan	JanPrins	1
KyuseokShim	Jong-HwaLim	1
YannisKotidis	NickRoussopoulos	2
Myung-WonKim	EunJuKim	1
YufeiTao	HuipingCao	1
UgurG*d*kbay	*zg*rUlusoy	1
DarioMalchiodi	BrunoApolloni	1
RobertoTagliaferri	GiancarloRaiconi	1
PatrickE.O'Neil	GideonSchaller	1
MichaelPowers	HillolKargupta	1
StefanSiersdorfer	SergejSizov	1
OsmarR.Za*ane	Maria-LuizaAntonie	1
PrasannaGanesan	JenniferWidom	1
JamesT.Scoggins	D.CalvinAndrus	1
StefanBrecheisen	MarcoP*tke	1
MaxJ.Egenhofer	ErikG.Hoel	1
YuJiang	YanChen	1
SumitK.Sanghai	DeepakVerma	1
ShojiroNishio	MasahikoTsukamoto	1
JoelE.Richardson	JananT.Eppig	1
TimothyRoscoe	RyanHuebsch	1
YaboXu	HongjunLu	1
RuomingJin	AnjanGoswami	1
Jean-Fran*oisBoulicaut	C*lineRobardet	1
StephenBoyer	OliverDain	1
MunirCochinwala	HiraAgrawal	1
StevenMinton	LiseGetoor	1
YounghwanLim	JaeGakHwang	1
WilliamF.Punch	AlexanderP.Topchy	1
WensiXi	ShuichengYan	1
MassimoMecella	ArantzaIllarramendi	1
WenfeiFan	CheeYongChan	2
BeysimSezgin	AlazelAcheson	1
WensiXi	Gui-RongXue	3
ZhihuaWang	DennisShasha	1
TimothyM.Sutherland	NishantMehta	1
LaksV.S.Lakshmanan	H.V.Jagadish	2
JohnW.Byers	GeorgeKollios	1
SunilPrabhakar	AhmedK.Elmagarmid	1
LaraDeVinco	DiegodiBernardo	1
VivekR.Narasayya	SurajitChaudhuri	3
SrinivasR.Kashyap	KrishnaPrasadChitrapura	1
SanjayAgrawal	BeverlyYang	1
ZhengChen	QiangYang	4
ShixiaLiu	LiZhang	1
TonyF.Chan	AndyM.Yip	1
YildirayKabak	AliYildiz	1
IvanPopivanov	AshrafAboulnaga	1
WilliamM.Shui	DamienK.Fisher	1
PhilipS.Yu	JiongYang	1
NickKoudas	AnthonyK.H.Tung	1
PhilippeCudr*-Mauroux	MonicaScannapieco	1
WaiLam	Tak-LamWong	2
UtkarshSrivastava	MayankBawa	1
GangLuo	CurtJ.Ellmann	1
JunRao	HamidPirahesh	1
SamuelBushra	MichaelPowers	1
MaurizioMazza	AnnaMaddalena	1
JonathanL.Herlocker	HyungilKim	1
JimMelton	FredZemke	1
ManhQ.Dinh	BoualemBenatallah	1
Wen-ChiHou	Chih-FangWang	1
SharmaChakravarthy	RamjiBeera	1
NormanW.Paton	ArijitMukherjee	1
YuMeng	JieHuang	1
YufeiTao	QiongmaoShen	1
StefanBrecheisen	Hans-PeterKriegel	3
YongShi	JingliLiu	1
SandraBerasaluce	GillesNiel	1
JacobBerlin	AmihaiMotro	1
SvenHelmer	NormanMay	1
DanielC.Zilio	ChristianGarcia-Arellano	1
SrujanaMerugu	DharmendraS.Modha	1
SudarshanS.Chawathe	SridharRamachandran	1
ShariqRizvi	EugeneWu0002	1
MehdiSharifzadeh	BaharehNavai	1
MichailVlachos	JessicaLin	1
WagnerMeiraJr.	SrinivasanParthasarathy	1
UgurG*d*kbay	EdizSaykol	1
KarimBa*na	BoualemBenatallah	1
S.Prabhakar	KuiyangLou	1
TakahiraYamaguchi	MihoOhsaki	1
SteliosPaparizos	H.V.Jagadish	1
RayidGhani	MarkoKrema	1
ThomasZurek	AchimKraiss	1
KeYi	HermanJ.Haverkort	1
KarlHahn	BerndReiner	1
IgorTatarinov	AlonY.Halevy	2
ParagSarda	JayantR.Haritsa	2
ZhengChen	QianShengCheng	1
GianluigiGreco	DomenicoSacc*	1
SudiptoGuha	AmitMarathe	1
WolfSiberski	UweThaden	1
MatthiasHampel	JostEnderle	1
TimosK.Sellis	Klaas-JanWinkel	1
ShengquanWang	NanZhang0004	1
NaokiAbe	BiancaZadrozny	1
PhilipA.Bernstein	DavidJ.DeWitt	1
XiMa	Kian-LeeTan	1
PrasenjitMitra	FotoN.Afrati	1
ZohrehNazeri	DanielBarbar*	1
QianShengCheng	HuaLi	1
LeiSheng	AbhinavGupta	1
JenniferWidom	DilysThomas	1
YongShi	HeeseokLee	1
JoshuaOldmeadow	ChristopherLeckie	1
RachidGuerraoui	JalelBen-Othman	1
TolgaBozkaya	AbhinavGupta	1
QiongmaoShen	KyriakosMouratidis	1
ZhengqingTang	JianpingLi	1
StefanoCeri	PieroFraternali	1
ZohrehNazeri	PingChen	1
ZacharyG.Ives	PhilipA.Bernstein	1
SeanC.Rhea	IonStoica	1
JiriSchindler	AnastassiaAilamaki	1
ZhanhuaiLi	YangZhang	1
YaBingChen	Mong-LiLee	1
GilHecht	EdenShochat	1
TovaMilo	IoanaManolescu	1
YannisVelegrakis	Ren*eJ.Miller	2
ZhenHuaLiu	VikasArora	1
VictorB.Zordan	EamonnJ.Keogh	1
ShawnR.Jeffery	ShariqRizvi	1
FaridParvini	BaharehNavai	1
QiHan	NaliniVenkatasubramanian	1
KenichiYoshida	FuminoriAdachi	1
SunilPrabhakar	JeffreyScottVitter	1
RuchitaBhargava	MiteshVasa	1
Mohand-SaidHacid	F*lixSaltor	1
SudiptoGuha	JungchulWoo	1
OmarBoucelma	AbdelkaderB*tari	1
VanessaP.Braganholo	CarlosA.Heuser	1
WenfeiFan	ByronChoi	2
YannisE.Ioannidis	FragkiskosPentaris	1
Tze-YunLeong	RohitJoshi	1
KristinaLerman	CraigA.Knoblock	1
RolfIngold	DenisLalanne	1
MagdalenaBalazinska	HariBalakrishnan	1
MeikelPoess	JohnM.Stephens	1
JunZhang	DimitrisPapadias	1
BrijM.Masand	BamshadMobasher	1
JunYan	BenyuZhang	3
MinosN.Garofalakis	GeorgeA.Mihaila	1
YimingMa	DawitYimamSeid	1
IonStoica	BoonThauLoo	2
XiaopengXiong	MohamedY.Eltabakh	1
RonnyMelz	KarstenB*hm	1
WeiwenYang	QiHan	1
MariaCarolinaMonard	GustavoE.A.P.A.Batista	1
HasanM.Jamil	GiovanniA.Modica	1
RanWolff	AssafSchuster	1
PaulJ.Kennedy	DavidB.Skillicorn	1
Yen-YuChen	TorstenSuel	1
ShanWang	GaoCong	1
ThomasRisse	KarlAberer	1
PanosVassiliadis	ManolisKoubarakis	1
JoydeepGhosh	InderjitS.Dhillon	2
WenyuanLi	Ee-PengLim	3
YiChen	GeorgeA.Mihaila	2
ChristianS.Jensen	BengChinOoi	1
ShiroOgasawara	NaokiIshihama	1
AnneDenton	AjayYekkirala	1
MayankBawa	KrishnaramKenthapadi	1
ZhiyongHuang	DanLin	1
LarsArge	HermanJ.Haverkort	1
EstherRyvkina	EduardoF.Galvez	1
WeiWang0011	HongjunLu	2
SamLightstone	IvanPopivanov	1
GeraldMoeller	DaveHislop	1
LucBouganim	G*r*meCanals	1
ZhongSu	LiZhang	1
MitsuruIshizuka	AdamJatowt	1
XingboYu	DmitriV.Kalashnikov	1
Maria-EstherVidal	LouiqaRaschid	1
MichailVlachos	EamonnJ.Keogh	2
AmolV.Wanjari	AbhijitKadlag	1
NathanFolkert	LeiSheng	1
SrinivasanParthasarathy	HuiYang	2
TovaMilo	NicoletaPreda	1
ZhengHuang	Jin-yiCai	1
EugeneWu0002	AnilEdakkunni	1
HillolKargupta	DavidHandy	1
ShiminChen	RogerS.Barga	1
WilliamPerrizo	FeiPan	1
EugeneJ.Shekita	BeverlyYang	1
GuyBernard	ClaudiaRoncancio	1
XinDong	JunZhang	1
SaileshKrishnamurthy	OwenCooper	1
PeterJ.Haas	PaulBrown	1
AnthonyStefanidis	Agn*sVoisard	1
SergeyMelnik	ChristophQuix	1
NaliniVenkatasubramanian	HaiminLee	1
GokceLaleci	AliYildiz	1
ConorCunningham	C*sarA.Galindo-Legaria	1
FrancescoBonchi	ClaudioLucchese	1
CarlosBeltr*n	CarlesFarr*	1
UtkarshSrivastava	SurajitChaudhuri	1
Chih-FangWang	AnandYendluri	1
RakeshAgrawal	AmyWang	1
LucDeRaedt	JohannesFischer	1
PaoloGarza	ElisaQuintarelli	1
ElizabethChang	CarloWouters	1
ShambhuJ.Upadhyaya	FaisalFarooq	1
MaoSongLin	HuiZhang	1
UlrichMeissen	StefanPfennigschmidt	1
JingShan	EvangelosKanoulas	1
Wei-YingMa	Jian-TaoSun	1
XiZhang	WynneHsu	1
JonathanGoldstein	JingrenZhou	1
YanFu	ShiguangShan	1
QiZhong	ChenLi	1
Jos*A.Blakeley	ChristianKleinerman	1
Ning-HanLiu	Chang-RongLin	1
MichaelF.Worboys	Agn*sVoisard	1
YongShi	WeixuanXu	2
YuxinChen	P*velCalado	1
WeiHong	FrederickReiss	1
PaulWatson	ArijitMukherjee	1
MariosHadjieleftheriou	DavidW.Cheung	1
SharadMehrotra	BijitHore	2
YaxiaoSong	HuaLu	1
RobertoTagliaferri	GiuseppeLongo	1
PatriciaSerrano-Alvarado	GuyBernard	1
ZhenHuaLiu	AnandManikutty	1
BogdanCautis	BogdanAlexe	1
WeiwenYang	NaliniVenkatasubramanian	1
St*phaneGan*arski	PatrickValduriez	1
DavidJ.DeWitt	AnastassiaAilamaki	1
HaesunPark	CheongHeePark	1
YoonkyongLee	AnHaiDoan	1
HamidPirahesh	AndreyBalmin	1
JenniferT.Chayes	AminSaberi	1
RaghuRamakrishnan	KristenLeFevre	1
NaliniVenkatasubramanian	JehanWickramasuriya	1
Mois*sGoldszmidt	IraCohen	1
JohannesGehrke	DanielKifer	1
SpirosSkiadopoulos	PanosVassiliadis	1
StefanoCeri	MarcoDario	1
TizianaCatarci	Mohand-SaidHacid	1
YanFu	HaipengWang	1
OliverSeeliger	LeoGiakoumakis	1
RamanathanV.Guha	DavidLiben-Nowell	1
RicardoA.Baeza-Yates	CarlosA.Hurtado	1
YongShi	XiaojunChen	1
YimingMa	QiZhong	1
TovaMilo	BogdanCautis	2
MartinH.C.Law	AnilK.Jain	2
AsumanDogac	AliYildiz	1
Shian-HuaLin	I-AneHuang	1
PradiptaMaji	ParimalPalChaudhuri	1
TengjiaoWang	LiyuLi	1
OmerZaafrany	MarkLast	1
JinHu	BengChinOoi	1
YuhanCai	RaymondT.Ng	1
RobertGwadera	IhabF.Ilyas	1
Il-YeolSong	AriD.Brooks	1
BiancaSchroeder	AnastassiaAilamaki	1
StefanoValtolina	PietroMazzoleni	1
GerhardWeikum	ChristianZimmer	1
XinWang	HowardJ.Hamilton	1
F*lixSaltor	ErichJ.Neuhold	1
ShuichengYan	ChenyongHu	1
VijayshankarRaman	DavidE.Simmen	2
XiaoMingZhou	Chuan-HengAng	1
YuchangLu	Hua-JunZeng	1
MaxJ.Egenhofer	Agn*sVoisard	1
MichaelBada	DanieleTuri	1
JayavelShanmugasundaram	ChavdarBotev	1
StefanBrandl	AlfonsKemper	1
JosephM.Hellerstein	BrentN.Chun	1
JenniferWidom	DavidJ.DeWitt	1
MohamedG.Elfeky	MiretteS.Marzouk	1
NamitaSingla	DanA.Simovici	1
NikosMamoulis	ManLungYiu	2
RalfSchenkel	MinosN.Garofalakis	1
TokWangLing	MengLou	1
LucianPopa	CongYu	1
YidaWang	Ee-PengLim	1
SudarshanMurthy	LoisM.L.Delcambre	1
JudithA.Blake	JamesA.Kadin	1
StephanSchosser	Kai-UweSattler	1
YuePan	LiZhang	2
StefanoSpaccapietra	Mohand-SaidHacid	1
YusukeSuzuki	TakayoshiShoudai	1
MarioMedvedovic	JunhaiGuo	1
PinarDuygulu	Hyung-JeongYang	1
QimingHuang	QiangYang	1
JayantR.Haritsa	AmolV.Wanjari	1
DavidMaier	ArvindArasu	1
Zo*Lacroix	HymaMurthy	1
YunPeng	R.ScottCost	1
MotiSchneider	MenahemFriedman	1
TimothyM.Sutherland	LupingDing	1
MiteshVasa	KunLiu	1
Kuo-ZuiLin	Kuo-YuHuang	1
MuneakiOhshima	MingxinHuang	1
ZongfangZhou	YongShi	1
NareshNeelapala	JayantR.Haritsa	1
PremMelville	FosterJ.Provost	1
ThomasRisse	StefanoSpaccapietra	1
UweDick	KristianKersting	1
XingboYu	QiHan	1
RohanA.Baxter	LifangGu	1
SabahCurrim	CurtisE.Dyreson	1
OlgaDeTroyer	ErichJ.Neuhold	1
JenniferNeville	BrianGallagher	1
SergioMarti	PrasannaGanesan	1
YuxinChen	WeiguoFan	1
JiongYang	JiaweiHan	2
DinaQ.Goldin	Agn*sVoisard	1
GeneTsudik	BalakrishnaR.Iyer	1
RudiStuder	PhilippeCudr*-Mauroux	1
StefanoSpaccapietra	KarlAberer	1
M.Tamer*zsu	LukaszGolab	1
GiancarloRaiconi	CiroDonalek	1
NingLiu	BenyuZhang	1
YoungJinJung	KeunHoRyu	1
VarunKacholia	M.Tamer*zsu	1
YuQian	WeiLai	1
LucBouganim	ClaudiaRoncancio	1
YangZhang	YanTang	1
ZacharyG.Ives	GerhardWeikum	1
RonHutchison	ChristopherBesemann	1
ThomasSeidl	MartinPfeifle	1
BrachaShapira	AbrahamKandel	1
SpirosPapadimitriou	ChristosFaloutsos	2
XiaopengXiong	ThanaaM.Ghanem	1
RiccardoOrtale	GianniCosta	1
HonggangZhang	EbruErsan	1
IriniFundulaki	BogdanAlexe	1
RayidGhani	ChadM.Cumby	1
GiriKumarTayi	AshishGrover	1
RuiZhang0003	BengChinOoi	2
ShiguangShan	JunfaLiu	1
MohamedG.Elfeky	MohamedF.Mokbel	1
H.V.Jagadish	AnthonyK.H.Tung	1
RyanHuebsch	BoonThauLoo	2
ThanaaM.Ghanem	JeffreyScottVitter	1
RamachandranVenkatesh	HonggangZhang	1
PascalMolli	JalelBen-Othman	1
StratosIdreos	ChristosTryfonopoulos	3
NicolasM*ger	ChristopheRigotti	1
RamachandranVenkatesh	ChristianKleinerman	1
ZunpingCheng	BaileShi	1
DimitrisPapadias	ChristosFaloutsos	2
JohnF.Roddick	CarlMooney	1
SergeAbiteboul	IoanaManolescu	1
ShinParker	EugeneY.Sheng	1
YingFeng	AmrElAbbadi	1
MasumSerazi	AmalPerera	1
VolkerMarkl	GuyM.Lohman	3
JeanFerri*	G*r*meCanals	1
YvesKodratoff	AhmedAmrani	1
DavidReiner	DavidBarta	1
SharadMehrotra	RamaswamyHariharan	1
San-YihHwang	Ee-PengLim	1
VukErcegovac	KristenLeFevre	1
WeihuaWu	DongmeiRen	1
ShankarPal	GideonSchaller	2
D*nielFogaras	Bal*zsR*cz	1
RonnieBathoorn	ArnoSiebes	1
MehmetS.Aktas	MehmetA.Nacar	1
RudiStuder	EduardoMena	1
JianhongWu	GuojunGan	1
YonatanAumann	BinyaminRosenfeld	1
JenniferWidom	GaganAggarwal	1
StefanBehnel	AlejandroP.Buchmann	1
RajeevMotwani	DilysThomas	1
LinqiLiu	CalistoZuzarte	1
MatthiasSchubert	KarinKailing	1
MichaelPowers	KunLiu	1
WenyuanLi	Kok-LeongOng	1
VikasArora	JamesW.Warner	1
HeikkiMannila	EvimariaTerzi	1
Young-KooLee	JiaweiHan	1
SridharRajagopalan	EugeneJ.Shekita	2
MarkoKrema	AndrewE.Fano	1
JunChen	ElkeA.Rundensteiner	1
MitchCherniack	EduardoF.Galvez	1
MinosN.Garofalakis	MarcoMesiti	1
MartinRingwald	JananT.Eppig	1
JunfaLiu	HaipengWang	1
HuanLiu	HiroshiMotoda	1
KazuyaOkamoto	HidetoYokoi	1
OlfaNasraoui	BrijM.Masand	1
GiovannaGuerrini	BarbaraCatania	1
IoanaManolescu	BhavaniM.Thuraisingham	1
HongHaiDo	ErhardRahm	2
VasiliyMalakhov	QiangDing	1
Y*celSaygin	IgorNaiFovino	1
XuanhuiWang	Hua-JunZeng	1
Hua-JunZeng	Gui-RongXue	3
BrijM.Masand	BingLiu	1
MartinH.C.Law	AlexanderP.Topchy	1
RogerMingHiengTing	JamesBailey	1
ShawnR.Jeffery	JosephM.Hellerstein	1
RaymondT.Ng	AlanWagner	1
J*r*mieMary	AntoineCornu*jols	1
GillesNiel	AmedeoNapoli	1
GaganAgrawal	AnjanGoswami	1
KwangRyelRyu	JaehoKang	1
SandraD'Aguanno	AndreaPugliese	1
RobbertC.VanderLinden	MikeHanlon	1
YongShi	YiPeng	1
SerkanKirbas	AsumanDogac	1
KrishnaGade	GeorgeKarypis	1
YufeiTao	JeffreyConsidine	1
LiseGetoor	CraigA.Knoblock	1
Y.DoraCai	JiaweiHan	1
RichUrmston	DavidReiner	1
ToshihiroKamishima	ShotaroAkaho	1
ThanaaM.Ghanem	RahulShah	1
MichaelStonebraker	EduardoF.Galvez	1
QiangDing	AmalPerera	1
XiaobinMa	HuiXiong	1
TobiasMayr	HamidPirahesh	1
KakaliSarkar	DavidHandy	1
YirongXu	RakeshAgrawal	4
MariaHong	Joon-SungYoon	1
HolgerMeyer	AndreZeitz	1
RaghuKrishnapuram	KrishnaKummamuru	1
ShanWang	AnthonyK.H.Tung	1
SamLightstone	AshrafAboulnaga	1
ThomasZurek	StefanSigg	1
LeonardoGuerreiroAzevedo	GeraldoZimbrao	1
RonEguchi	CarterButts	1
MohamedY.Eltabakh	MohamedF.Mokbel	1
VasilisVassalos	RalfSchenkel	1
HamidPirahesh	DavidE.Simmen	2
PhilipBohannon	ByronChoi	1
HiraAgrawal	Chung-MinChen	1
Ming-SyanChen	Mi-YenYeh	1
ThomasHofmann	DavidGondek	1
AnthonyStefanidis	A.Howard	1
LuigiPontieri	GianluigiGreco	1
DaxinJiang	ChunTang	1
RakeshNagarajan	MushtaqAhmed	1
ThomasM.Tirpak	KaidiZhao	1
KenichiTakahashi	HiroakiUeda	1
YongYu	QiangYang	1
YingluoWang	KanliangWang	1
WilliamPerrizo	BaoyingWang	1
XiaodongLin	ChrisBeecher	1
PaulBradley	MelanieHilario	1
ZhiminHuang	SusanX.Li	1
YingZhao	GeorgeKarypis	1
JinSoungYoo	HuiXiong	1
TimosK.Sellis	PanosVassiliadis	1
JerryKiernan	ChristosFaloutsos	1
SurajitChaudhuri	GuyM.Lohman	1
MariaHong	Eun-YoungKim	1
MartinTheobald	ChristianZimmer	1
LinqiLiu	JarekGryz	1
JunFang	HonggangZhang	1
YizhouWang	CarloZaniolo	1
VolkerMarkl	AshrafAboulnaga	3
SzymonJaroszewicz	DanA.Simovici	2
PatrickE.O'Neil	AlanFekete	1
MichaelJ.Franklin	JenniferWidom	1
WalidG.Aref	IhabF.Ilyas	2
RuixiangSun	QiangYang	1
PeerKr*ger	ArthurZimek	1
SpirosSkiadopoulos	ManolisKoubarakis	1
SankarSubramanian	NathanFolkert	1
YongShi	Kwong-SakLeung	1
JudithA.Blake	CarolJ.Bult	1
VenkateshGanti	LuisGravano	1
SandraD'Aguanno	IoanaManolescu	1
RaghuRamakrishnan	HongfeiGuo	2
Mong-LiLee	BengChinOoi	1
ZhuomingXu	YishengDong	1
EduardoF.Galvez	DavidMaier	1
ThomasRisse	RudiStuder	1
ShankarPal	PatrickE.O'Neil	1
TimothyRoscoe	SamMardanbeigi	1
ShiweiTang	ChanjunYang	1
KarstenB*hm	ChristianBiemann	1