Sheng-KunHwang	Ming-YenLin	1
IllhoiYoo	Il-YeolSong	1
MehdiEssid	Fran*ois-MarieColonna	1
XiaoweiXu	Chun-YangFan	1
RichardD.SissonJr.	CarolinaRuiz	1
MohammedJaveedZaki	BoleslawK.Szymanski	1
ZonghongZhang	GaoCong	1
ZhipingZeng	GeorgeKarypis	1
CarolinaRuiz	AparnaS.Varde	1
XinLi	PhilipS.Yu	1
XingSun	JanPrins	1
ShengWang	ShanWang	1
SteffenRendle	LarsSchmidt-Thieme	1
LarryPryor	EduardH.Hovy	1
MichaelSchroeder	Lo*cRoyer	1
ShengMa	MarkBrodie	1
FengCao	AoyingZhou	1
ZhihuiWang	S.H.Boey	1
HuiZhao	DouShen	1
Kam-FaiWong	HaifengJiang	1
FrederickH.Lochovsky	Dit-YanYeung	1
KenjiTakeda	ArumugamPaventhan	1
YongYu	YifengShao	1
RaghunathOthayothNambiar	MeikelPoess	1
SigalSahar	JaideepSrivastava	1
SumitNegi	RaghuKrishnapuram	1
YujiMatsumoto	DaichiMochihashi	2
SunilPrabhakar	SongLiu	1
Shinn-JangHo	Hui-LingHuang	1
NuweeWiwatwattana	LaksV.S.Lakshmanan	1
LawrenceGibbons	JuliaDeneva	1
QinfengGuo	LijunChen	1
WalterA.Kosters	JeroenS.deBruin	1
MehdiSharifzadeh	AliKhodaei	1
RicardoA.Baeza-Yates	ArturZiviani	1
StephenRobertson	ChrisBurges	1
RezartaIslamajDogan	LiseGetoor	1
ChristophSturm	ChristophKiefer	2
WitoldLitwin	ThomasJ.E.Schwarz	1
RainerGemulla	PeterJ.Haas	1
YutakaKabutoya	TakayukiYumoto	1
HuanLiu	DavidW.Cheung	1
JavedA.Aslam	EmineYilmaz	1
IlvioBruder	HeikoJahnkuhn	1
VijayGandhi	EricD.Kolaczyk	1
OrlandoAvila-Garc*a	J.L.RodaGarc*a	1
WilliamY.Arms	GregoryJ.Sharp	1
MichaelChau	JackeyNg	1
ShivakumarVaithyanathan	PrasadM.Deshpande	1
SelcukAya	GregoryJ.Sharp	1
TaoLi	FeiWang	1
Jun'ichiTatemura	BelleL.Tseng	1
YongYu	DingyiHan	1
SigalSahar	AmitBose	1
RebeccaCasta*o	AshleyDavies	1
NathanGood	DennisDeCoste	1
NicolasRoper	KlemensB*hm	1
MinosN.Garofalakis	IonStoica	1
J*r*meDavid	FabriceGuillet	1
T.S.Jayram	DouglasBurdick	1
SourashisRoy	D.V.S.Ravikant	1
Yuan-BinChang	Ping-YuHsu	1
PeerKr*ger	ElkeAchtert	5
ZijianZheng	EugeneAgichtein	1
WeiJin	RohiniK.Srihari	1
PhilipS.Yu	FeidaZhu	1
StephenChi-faiChan	EdwardK.F.Dang	1
ZhaohuiPeng	BolinDing	1
MichalisPotamias	KostasPatroumpas	1
ChristophF.Eick	BanafshehVaezian	1
PeiyaLiu	JohnPearson	1
ZhenbangRong	YongHu	1
IlujuKiringa	DanZhao	1
Mi-YenYeh	Bi-RuDai	1
SteveA.Chien	NghiaTang	1
GermanShegalov	GerhardWeikum	1
JosiahPoon	AijunAn	1
DavidCampbell	AnilNori	1
EvanHoke	ChristosFaloutsos	1
MatthiasBender	ChristianZimmer	1
Ming-ShienShan	AsumanSuenbuel	1
MichaelCammert	J*rgenKr*mer	3
ChenChen	ChaoLiu0001	1
WeiningQian	MartinEster	1
Sue-ChenHsueh	Ming-YenLin	1
LizhuZhou	JianyongWang	6
JihuaHuang	HuipingLi	1
WenfeiFan	MichaelFlaster	1
XinZhou	HetalThakkar	1
KonstantinosStamos	DimitriosKatsaros	1
SriramKrishnan	RaduStefanNiculescu	1
ZhengxinChen	GangKou	3
JohnMylopoulos	DanZhao	1
MaartenMarx	LoredanaAfanasiev	1
ShenghuaBao	BingLiu	1
NamyounChoi	Il-YeolSong	1
VikramGoyal	IndiraMeshram	1
HectorGonzalez	DiegoKlabjan	1
J.L.RodaGarc*a	A.Est*vezGarc*a	1
KazunoriOkada	GlennFung	1
SunKim	KwangminChoi	1
YunmingYe	XiaojunChen	1
HillolKargupta	ChrisGiannella	2
KaushikChakrabarti	DongXin	1
JeffreyChan	ChristopherLeckie	1
Fang-FeiKuo	Chin-ChuanHo	2
SelcukAya	JuliaDeneva	1
LucDeRaedt	Bj*rnBringmann	1
HuanHuo	ChuanXiao	1
QiangYang	BenyuZhang	3
GerdStumme	AndreasHotho	1
Ren*eJ.Miller	LucianPopa	1
XingwenWang	JoshuaZhexueHuang	1
CorsinDecurtins	BeatSigner	1
YangSong	JianHuang0002	1
SubhashSuri	NisheethShrivastava	1
ShengMa	LiuzhongYang	1
XintaoWu	SongtaoGuo	2
MarcellaAttimonelli	DonatoMalerba	1
SihemAmer-Yahia	ChavdarBotev	1
JohannesA*falg	Hans-PeterKriegel	4
MariosHadjieleftheriou	FeifeiLi	1
VibhutiS.Sengar	RangaRajuVatsavai	1
ZhenjieZhang	BengChinOoi	1
ElkeA.Rundensteiner	CarolinaRuiz	1
GuidoMoerkotte	AlexanderB*hm0002	1
Sang-WookKim	HeejinPark	1
SachinThatte	MichaelJ.Carey	1
HongxingHe	GrahamJ.Williams	1
PingWu	Ji-RongWen	1
LoisM.L.Delcambre	JamesF.Terwilliger	1
ErranL.Li	AbhishekKumar	1
YanminSun	MohamedS.Kamel	1
SharmilaSubramaniam	DimitriosGunopulos	1
JamesN.K.Liu	BoFeng	1
MaryF.Fern*ndez	J*r*meSim*on	1
DiveshSrivastava	BingTianDai	1
MichaelR.Lyu	EdwardY.Chang	1
OlivierBodenreider	HuiruZheng	1
YiFang0003	MyongKeeJeong	1
JihuaHuang	JianjunHao	1
TimosK.Sellis	ManolisTerrovitis	1
ThomasSchwarz	MarkManasse	1
VeeraraghavanVijayaraj	NagendraSingh	1
UmeshwarDayal	KeiYuasa	1
MuthiahChettiar	ChavdarBotev	1
GeneCooperman	DanielKunkle	1
Wang-ChienLee	GailMitchell	1
SimelaTopouzidou	M.Glittum	1
PetrosManiatis	MinosN.Garofalakis	1
SalvatoreGaglio	MichaelR.Berthold	1
MohamedZa*t	AllisonW.Lee	1
WillemJonker	MarkoSmiljanic	2
SrinathShankar	AmeetKini	1
ZeinaKoteiche	HalaOllaic	1
DimitrisPapadopoulos	DimitriosGunopulos	1
D.Green	AndrewRau-Chaplin	1
TamerKahveci	Orhan*amoglu	1
MoniqueNoirhomme-Fraiture	EtienneCuvelier	1
RaghuRamakrishnan	AlanFekete	1
RuiZhang0003	AnthonyK.H.Tung	1
ShijiSong	GuangFeng	1
KeishiTajima	ChiTian	1
PaoloCiaccia	MarcoPatella	1
Mohd.NoorMd.Sap	A.MajidAwan	1
Ching-ChiHsu	Chen-MingHsu	1
NicolasCebron	MichaelR.Berthold	1
PhilipS.Yu	ChaoLiu0001	1
IraAssent	BorisGlavic	1
XueminLin	HaixunWang	1
RongGe	MartinEster	1
TaoLi	ShengMa	1
AndrewWitkowski	AllisonW.Lee	1
DanLin	BengChinOoi	1
JamesCheney	AdrianeChapman	1
YongShi	JingranDai	1
RichiNayak	JanLovie-Kitchin	2
RussellGreiner	DengyongZhou	1
ValTannen	ToddJ.Green	1
JeffreyXuYu	HuanLiu	1
QuinnHart	JieZhang	1
PhilipS.Yu	MichailVlachos	5
KwangJinPark	Kwang-SikChung	1
ShuichengYan	NingLiu	1
YunhaoLiu	QiongLuo	1
SilviuCucerzan	C.LeeGiles	1
TorstenSteinbach	RangaRajuVatsavai	1
VanjaJosifovski	RaviKumar	1
SriramRaghavan	RajasekarKrishnamurthy	1
SuchandraGoswami	OlfaNasraoui	1
KevinS.Beyer	Fatma*zcan	1
MonicaScannapieco	LaureBerti-Equille	1
PeterBuneman	GaoCong	1
MasakazuKumakiri	KenHiguchi	1
ShoushenYang	MuraliMani	1
ParagAgrawal	JenniferWidom	1
ToddC.Mowry	BruceM.Maggs	1
Kun-TaChuang	Jiun-LongHuang	1
XibeiJia	AnastasiosKementsietsidis	1
SamLightstone	ChristianGarcia-Arellano	1
NicolaOnose	DanielEngovatov	1
FilippoFurfaro	CristinaSirangelo	1
GerdStumme	BernhardGanter	1
ZheweiJiang	Chih-FangWang	1
SaraCohen	BennyKimelfeld	1
Vil*mVychodil	RadimBelohl*vek	1
OlivierVerscheure	EricBouillet	1
LiZhuang	FengJing	1
HimanshuGupta	AditiPandit	1
Tie-YanLiu	LiGao	1
VivekR.Narasayya	SanjayAgrawal	1
XuesongMa	BettinaKemme	1
WilliamM.Pottenger	MooiChooChuah	1
ZhijieChen	WeizhenChen	1
RaghavKaushik	ArvindArasu	1
GeorgePallis	AthenaVakali	1
GennaroBruno	ChristineCollet	1
RongHu	LeiZou	1
Hj*rdisHoff	CesarePautasso	1
PingWu	CaijieZhang	1
OlivierVerscheure	LisaAmini	1
JaideepSrivastava	BrijM.Masand	1
TakayukiTamura	MasaruKitsuregawa	1
MauricevanKeulen	JensTeubner	2
MinjiWu	JianliangXu	1
SimelaTopouzidou	CesarePautasso	1
RomanSchmidt	ManfredHauswirth	1
KevinChen	AllenMiu	1
YaoWu	MarelisCardenas	1
FilliaMakedon	AmitChakrabarti	1
KimihiroYamamoto	AtsushiKobayashi	1
TatsuyaMori	KeisukeIshibashi	1
ShuangHou	Hans-ArnoJacobsen	1
SihemAmer-Yahia	EmiranCurtmola	1
ZifangHuang	JilianZhang	1
WenweiXue	LeiChen0002	1
ZhiyongHuang	BengChinOoi	2
HeikoJahnkuhn	AndreasHeuer	1
HeikkiMannila	GautamDas	1
ChangzhouWang	AnneHunt	1
Wei-YingMa	KefengDeng	1
SouripriyaDas	JagannathanSrinivasan	1
QinmingHe	QiQiang	1
Hua-GangLi	DivyakantAgrawal	2
MaytalSaar-Tsechansky	BiancaZadrozny	1
ZhangBin	WangBo	1
JamesS.Friedman	AnandSwaroop	1
RossGayler	CliftonPhua	1
YanHuang	PushengZhang	1
YaronKanza	AlbertoO.Mendelzon	1
NaiyangDeng	KunZhao	1
VladimirCherkassky	ChandraKambhamettu	1
SasoDzeroski	HendrikBlockeel	1
PanagisMagdalinos	ChristosDoulkeridis	1
JunjieWu	JianChen	1
YumingOu	YanchangZhao	1
RichCaruana	AlexandruNiculescu-Mizil	2
ChenChen	CharuC.Aggarwal	1
MichaelJ.Franklin	DavidMaier	1
PhilipS.Yu	BingLiu	1
RuiWang0002	MohamedF.Mokbel	1
PhilipS.Yu	DeepakRajan	1
Min-JaeLee	Kyu-YoungWhang	1
RongZhang	AoyingZhou	1
LiseGetoor	IndrajitBhattacharya	2
SidduP.Algur	P.S.Hiremath	1
DeborahS.Gross	DavidR.Musicant	1
MuraliMani	MagedEl-Sayed	1
MatthiasRenz	ElkeAchtert	2
HuahaiYang	H.V.Jagadish	1
RangaRajuVatsavai	D.V.S.Ravikant	1
SandeepMane	ColinDeLong	1
Seung-CheonBaek	Han-DeokLee	1
KunGao	AnastassiaAilamaki	1
Wei-YingMa	BinGao	1
Yi-TingLai	DaymondLing	1
R.BharatRao	JinboBi	2
MirekRiedewald	FanYang0002	2
YiWang	LizhuZhou	1
InaM*ller-Gorman	ElkeAchtert	1
StefanKrompass	AlfonsKemper	1
YaoWu	JensBleiholder	1
JohnRiedl	AdamLaPitz	1
RafaelPe*aloza	AlexanderKozlenkov	1
XuanhuiWang	Jian-TaoSun	1
SamikBasu	RobynR.Lutz	1
DengyongZhou	DaleSchuurmans	1
VetleI.Torvik	NeilR.Smalheiser	1
KirkPruhs	AlexandrosLabrinidis	1
JeffreyF.Naughton	AlanHalverson	1
DavidT.Potere	AuroopR.Ganguly	1
SivaGurumurthy	AmitAnilNanavati	1
NarenRamakrishnan	MohammedJ.Zaki	1
VijayGandhi	JunchangJu	1
QingLiu	MinghuaZeng	1
WindsorW.Hsu	SoumyadebMitra	1
LiyingSui	DayouZhou	1
WynneHsu	ChangSheng	2
YoonhoPark	NavenduJain	1
SuratnaBudalakoti	EmmanuelD.Pontikakis	1
RaymondChi-WingWong	AdaWai-CheeFu	1
DimitriosKatsaros	AntonisSidiropoulos	1
XiaoyunHui	GuorenWang	1
AndrewEisenberg	AmyKrause	1
ShawnPearce	MariaLuisaSapino	1
SunilPrabhakar	BinYao	1
SarunasGirdzijauskas	KarlAberer	1
SrinathShankar	JeffreyF.Naughton	1
Chih-FangWang	ChengLuo	1
GeorgePallis	DimitriosKatsaros	1
TamaraA.Schwimmer	HyoilHan	1
ShenodaGuirguis	KhalilM.Ahmed	1
YasushiSakurai	MasashiYamamuro	1
PengWang	BaileShi	1
Ki-JouneLi	Chan-HyunKang	1
YuxinMao	HuajunChen	1
PeterKunath	ElkeAchtert	2
NadirWeibel	CorsinDecurtins	1
ZhoujunLi	JianWen	1
S.Sudarshan	NishantKapoor	1
AnupamJoshi	AmitAnilNanavati	1
QiongHuang	FrederickH.Lochovsky	1
SuzanneM.Embury	PaoloMissier	1
Lo*cRoyer	GihanDawelbait	1
ShantanuJoshi	ChrisJermaine	1
MatthiasNicola	KevinS.Beyer	1
ShoushenYang	ElkeA.Rundensteiner	1
Hans-PeterKriegel	ElkeAchtert	3
JureLeskovec	AjitSingh	1
TamerKahveci	ChristopherM.Jermaine	1
ElkeA.Rundensteiner	DanielJ.Dougherty	1
MichaelGruber	Hans-PeterKriegel	1
VibhutiS.Sengar	LaurentMignet	1
MarcosR.Vieira	AgmaJ.M.Traina	1
JingWang0007	ChristophF.Eick	2
MohammedJaveedZaki	BouchraBouqata	1
LucianPopa0002	ArsalanTavakoli	1
ThomasDoggett	AshleyDavies	1
HolgerBast	GerhardWeikum	1
ShubhaU.Nabar	ArndChristianK*nig	1
ShaileshJoshi	FaizCurrim	1
KevinY.Yip	BenKao	1
YapingLi	RakeshAgrawal	1
SoonYoungJung	Ki-SikKong	1
WenJin	WeiningQian	2
VincenzoMinei	CristianDumitrescu	1
HeliHiisil*	EllaBingham	1
JeffreyXuYu	HaifengJiang	1
DenisA.Nicole	ArumugamPaventhan	1
JiaWang	ErranL.Li	1
XiaomingJin	Jia-GuangSun	1
K.Sel*ukCandan	DivyakantAgrawal	4
PrasanRoy	LaurentMignet	1
YannisKotidis	DiveshSrivastava	1
IppokratisPandis	AnastassiaAilamaki	1
QiangYang	HuiZhao	1
IonutEmilIacob	AlexDekhtyar	1
PauloMartinsEngel	Jo*oFranciscoValiati	1
KannanGovindarajan	HarumiA.Kuno	1
TaroTezuka	KeishiTajima	1
XiaohuiYu	NickKoudas	2
BettinaKemme	BeibeiZou	1
SimelaTopouzidou	RoyGr*nmo	1
YoonhoPark	HenriqueAndrade	1
JustinBrickell	DharmendraS.Modha	1
SouravS.Bhowmick	SanjayKumarMadria	1
Yuan-BinChang	Yen-LiangChen	1
Yi-ChengTu	BinYao	1
WilliamL.Barth	PatrickHurley	1
MemaRoussopoulos	JeffreyShneidman	1
LongbingCao	JiaruiNi	1
RobertGruber	KathleenFisher	1
KuoZhang	GangWu	1
ZujiaXu	XiaojingYuan	1
Jae-GilLee	Il-YeolSong	1
DanC.Stefanescu	AlexThomo	1
Jian-YunNie	GuihongCao	1
MujdePamuk	JoachimHammer	1
KunalPunera	ArisAnagnostopoulos	1
StefanKramer	JohannesFischer	1
HuyT.Vo	EmanueleSantos	2
PaoloPapotti	C.T.HowardHo	1
RuomingJin	ChrisJermaine	1
StanMatwin	JustinZ.Zhan	1
SiweiLuo	LianweiZhao	1
StavrosHarizopoulos	KunGao	1
YanchangZhao	LongbingCao	1
ZhaohuiPeng	ShanWang	1
RonenFeldman	RobertGrossman	2
FacundoBromberg	DimitrisMargaritis	1
JiepingYe	ChandraKambhamettu	1
BiancaSchroeder	AdamWierman	1
WeiFan	JoeMcCloskey	1
JingliLu	JeffreyXuYu	1
Kian-LeeTan	H.V.Jagadish	3
PanagiotisG.Ipeirotis	LuisGravano	1
WeiningQian	ShuigengZhou	2
ToshiyukiAmagasa	HiroyukiKitagawa	1
Mar*adelMarRold*nGarc*a	Jos*FranciscoAldanaMontes	1
SergeAbiteboul	NeoklisPolyzotis	1
ZhigangZhang	XiaomingLi	1
PeterChristen	AlanWillmore	1
WalkerM.White	MirekRiedewald	1
SushilK.Prasad	DavidFisher	1
Jian-TaoSun	Hua-JunZeng	1
FengShao	AnandBhaskar	1
OlatzArbelaitz	Jos*IgnacioMart*n	1
Wei-ShinnKu	Chi-NgaiWan	1
SimonSheu	NigelWu	1
RaymondK.Wong	DamienK.Fisher	1
SonnyVaupel	J*rgenKr*mer	1
NickPinto	AltigranSoaresdaSilva	1
NianjunLiu	MichaelJ.Hill	1
XiaojingYuan	ChristophF.Eick	1
ScottKlasky	ManishParashar	1
MuratKantarcioglu	DmitriAsonov	1
KeWang	JamesN.K.Liu	1
NinaMishra	BhaskaraMarthi	1
KaruturiR.KrishnaMurthy	HaixiaLi	1
MichaelK.Ng	MarkJunjieLi	1
RonnyLempel	IdoGuy	1
ShusakuTsumoto	ShigekiYokoyama	1
JagannathanSrinivasan	GeorgeEadon	1
PauloJ.Azevedo	Al*pioM*rioJorge	1
RuiWang0002	RogerS.Barga	1
TakahiraYamaguchi	ShusakuTsumoto	3
ValentinKuznetsov	DanielRiley	1
ChristosFaloutsos	Andr*G.R.Balan	1
MauricevanKeulen	MarkoSmiljanic	2
WilfredNg	JamesCheng	4
PerAhlgren	LeifGr*nqvist	1
KatjaHose	ChristianLemke	1
RichardKing	LisaAmini	1
XiaohuaHu	IllhoiYoo	3
RuiZhou	BoNing	1
PavelDmitriev	ManuelCalimlim	1
SioIongAo	MarkJunjieLi	1
MarcosR.Vieira	CaetanoTrainaJr.	1
HongkunZhao	ClementT.Yu	1
XiaojingYuan	IanDavidson	1
YannisPapakonstantinou	NicolaOnose	1
MohamedFaridElhawary	ArtMunson	1
YongluanZhou	YingYan	1
O.Martin	IoannisPitas	1
LingLiu	LiXiong	1
StefaniaLeone	KlausR.Dittrich	1
NghiaTang	DominicMazzoni	1
YanshengLu	HuamingZhang	1
TakeshiSuzuki	HaraldHolz	1
YassineLassoued	PaolaPodest*	1
Li-RongDai	HongJiangZhang	1
HuiruZheng	HaiyingWang	1
ToshihikoYamasaki	GamhewageC.deSilva	1
RichardD.SissonJr.	MohammedManiruzzaman	1
Jos*FernandoRodriguesJr.	HanghangTong	1
JianjunXu	BaileShi	1
KiriWagstaff	IanDavidson	1
YangSong	C.LeeGiles	1
YongShi	YingLiu	1
ShashankPandit	ChristosFaloutsos	1
KimihiroYamamoto	HitoakiSakamoto	1
XiaoleiLi	DongXin	1
VickyNassis	TharamS.Dillon	1
HuiDing	GoceTrajcevski	1
MarcoSaerens	Fran*oisFouss	1
KurtDriessens	BernhardPfahringer	1
RicoWind	KristianTorp	1
JordiRoig	Jes*sCerquides	1
ManjaNelius	HeikoJahnkuhn	1
SasoDzeroski	JanStruyf	1
RoyGr*nmo	GeorgeAthanasopoulos	1
JosephM.Hellerstein	ArsalanTavakoli	1
M.Glittum	Arne-J*rgenBerre	1
MassimoFranceschet	MaartenMarx	1
WynneHsu	JinyanLi	1
MirekRiedewald	JohannesGehrke	5
MichaelChau	BenKao	2
BernardoMiranda	AlexandreA.B.Lima	1
ShuqiangYang	BoDeng	1
TerryCaelli	NorazwinBuang	1
HuabeiYin	BoXu	1
MohamedF.Mokbel	DavidB.Lomet	1
MichaelPeterHaustein	KonstantinLuttenberger	1
JeroenS.deBruin	JeroenF.J.Laros	1
VasilisVassalos	HarisGeorgiadis	1
PavelDmitriev	JimCordes	1
PavelDmitriev	ChristopherD.Jones	1
Han-DeokLee	Gye-JeongKim	1
MaytalSaar-Tsechansky	GaryM.Weiss	1
NghiaTang	BenjaminCichy	1
XindongWu	FengChen	1
OliverPo	Jun'ichiTatemura	1
VibhutiS.Sengar	SourashisRoy	1
TakayukiYumoto	SatoshiOyama	1
TimK.Cocx	JeroenF.J.Laros	1
MaryF.Fern*ndez	ChristopherRe	1
LuQin	JunZhang	1
XiaoleiLi	JiaweiHan	4
WeiqiangLin	MehmetA.Orgun	1
TaoLi	StephenR.Holbrook	1
YoungheeLee	DongmanLee	1
TorstenGrust	StefanManegold	2
RyoTaguchi	KensukeOhta	1
GiovanniDaSanMartino	AlessandroSperduti	1
YongZhang	GuoliangLi	1
YiZhang0001	DamianEads	1
WendyHuiWang	LaksV.S.Lakshmanan	2
Sheau-DongLang	HaoCheng	1
JohannesGehrke	DanielRiley	1
DanielBarbar*	CarlottaDomeniconi	1
SangKyunCha	P.Anandan	1
YangDu	DonghuiZhang	2
SanjayChawla	PeiSun	1
JoannJ.Ordille	AnandRajaraman	1
DongqingYang	AiqiangGao	1
SergeAbiteboul	EmanuelTaropa	1
KouzouOhara	HiroshiMotoda	1
LingLiu	BugraGedik	1
NimrodMegiddo	MarcelKutsch	2
NarenRamakrishnan	DeeptKumar	1
YingXu0002	RaviKumar	1
DonghuiZhang	DanielKunkle	1
PauliMiettinen	GautamDas	1
TiankaiTu	AnastassiaAilamaki	1
MingDong	ManjeetRege	1
XinghuaHu	BinWu	1
StefanManegold	MauricevanKeulen	2
LeonardBrown	LeGruenwald	1
EdwardY.Chang	AnkurJain	1
KevinSmathers	KeiYuasa	1
KaoruMaeda	AndreasDengel	1
KaidiZhao	BingLiu	2
MinosN.Garofalakis	BoonThauLoo	1
Mong-LiLee	JunmeiWang	1
MaheshShrestha	KenKonkel	1
TimChurches	AlanWillmore	1
TakeshiSuzuki	OlegRostanin	1
Vicen*Soler	JosepSabria	1
ChristopherD.Jones	AndersRyd	1
Yan-QingZhang	RajshekharSunderraman	1
Yoo-SungKim	Sang-HyukLim	1
KaraneVieira	AltigranSoaresdaSilva	1
PaoloCappellari	PaoloAtzeni	1
RonnyLempel	AndreiZ.Broder	1
LeahE.Steinberg	DeborahS.Gross	1
ThomasSeidl	RalphKrieger	1
ZhiZhou	CharlesX.Ling	1
LuisHoyos	ArturBoronat	1
PrasanRoy	HimanshuGupta	1
YingLi	JunYan	2
WeiZhuang	S.Muthukrishnan	1
ZhenjieZhang	Kian-LeeTan	2
MirekRiedewald	GregoryJ.Sharp	1
XiaohuaHu	HyoilHan	1
LuisOt*vioAlvares	Jo*oFranciscoValiati	1
ZhenyuChen	WeixuanXu	1
FlorisGeerts	DiegoMilano	2
Jos*FernandoRodriguesJr.	AgmaJ.M.Traina	1
ShouyangWang	LeanYu	1
MargoI.Seltzer	JeffreyShneidman	1
Zo*Lacroix	BenSnyder	1
MarcoCristo	AdrianoVeloso	1
TaneliMielik*inen	SvenLaur	1
RonenFeldman	BinyaminRosenfeld	2
MichaelHerscovici	EugeneJ.Shekita	1
MartinEster	BoazBen-Moshe	1
GuangFeng	BinGao	1
Tie-YanLiu	SouravS.Bhowmick	1
MarcoGori	AugustoPucci	1
JiayuanHuang	DaleSchuurmans	2
YaoWu	SamirKhuller	1
LawrenceB.Holder	ChangHunYou	1
ToshiroKubota	SenthilPeriaswamy	1
ShuohaoZhang	CurtisE.Dyreson	1
TakenaoOhkawa	HitohiroShiozaki	1
SudiptoGuha	DiveshSrivastava	1
JuliaDeneva	AndersRyd	1
RajeevMotwani	NinaMishra	1
TonyFallon	HongxingHe	1
SandeepTata	JigneshM.Patel	1
WilfredNg	JuzhenHe	1
YuelongJiang	WeiningQian	1
XuesongMa	GlenNewton	1
MyraSpiliopoulou	JaideepSrivastava	1
MinosN.Garofalakis	GrahamCormode	2
ChristosFaloutsos	CaetanoTrainaJr.	1
TengjiaoWang	ShiweiTang	1
LiLiu	BhavaniM.Thuraisingham	1
MoiraC.Norrie	BeatSigner	1
ZhengZhang	WeiningQian	2
PeterKunath	Hans-PeterKriegel	6
RaviJanardan	JinboBi	1
MinoruKanehisa	KosukeHashimoto	1
MichailVlachos	EricBouillet	1
ZudeLi	XiaojunYe	1
ClementT.Yu	AbdurChowdhury	1
SimonasSaltenis	AlbrechtSchmidt0002	1
YingXu0002	ShubhaU.Nabar	1
DavePearson	AmyKrause	1
OmarBoucelma	MehdiEssid	1
VibhoreKumar	BrianF.Cooper	1
TysonCondie	DavidE.Gay	1
RongZhang	BengChinOoi	2
WeiDing0003	JingWang0007	1
XiaoyanLi	LidanShou	1
SugatoBasu	KiriWagstaff	1
SamuelMadden	EugeneShih	1
LijuanZhang	HuowangChen	1
Hyeon-JoongYoo	DaeWoongRhee	1
SrikantaJ.Bedathur	GerhardWeikum	1
MyongKeeJeong	Hyun-WooCho	1
XiaoyanLi	GangChen	1
KonstantinosStamos	GeorgePallis	1
Mar*aJ.Escalona	AntoniaM.ReinaQuintero	1
PeterJ.Haas	MarcelKutsch	3
SibelAdali	AdamMarcus0002	1
LotharJ*nsch	ClaudiaHundertmark	1
ZhangMing	WangRonggui	1
Xu-DongZhang	Wei-YingMa	1
MahadevanSubramanian	InderpalNarang	1
YifengZheng	StevenBird	1
RongZhang	QuangHieuVu	2
PeterScheuermann	GeumJiCha	1
JianhongZhou	AshfaqA.Khokhar	1
YoungH.Cho	JohnW.Lockwood	1
XingSun	JinzeLiu	1
KosukeHashimoto	HiroshiMamitsuka	1
YuetingZhuang	YiZhuang	1
GeorgeKollios	GaryBenson	1
DanielRiley	ChristopherD.Jones	1
JeremyPickens	AndrewMacFarlane	1
ToddEavis	D.Green	1
MartinKnoblauch	IgnacioGarc*a	1
YassineLassoued	AlbertoBelussi	1
JianHuang0002	C.LeeGiles	2
YaoWu	NataliaMarquez	1
Pang-NingTan	HaibinCheng	3
VipinKumar	MarkShaneck	1
Zolt*nGy*ngyi	PavelBerkhin	1
MarcoCammisa	AlessandroMoschitti	1
KorinnaBade	AndreasN*rnberger	1
ValeriaDeAntonellis	DeniseSalvi	1
JunqiZhang	JianPei	1
OsmarR.Za*ane	GaborMelli	1
ShlomoGeva	RodneyWolff	1
WeiDing0003	ChristophF.Eick	1
YoshinobuYamashita	TadashiOhmori	1
JohnZimmerman	AnthonyTomasic	1
GustavoAlonso	AndreasWapf	1
YannisVelegrakis	DiveshSrivastava	1
SalvatoreOrlando	RaffaelePerego	2
MeteCelik	JinSoungYoo	2
YvonneMorrow	YumingOu	1
DingZhou	C.LeeGiles	2
SrinivasanParthasarathy	DonaldC.Trost	1
YanfengShu	BeiYu	1
StephenD.Scott	MattCulver	1
KevinChen-ChuanChang	ChengkaiLi	1
Kyong-IKu	Ki-ChangKim	1
SunilPrabhakar	ReynoldCheng	1
SouravS.Bhowmick	LeGruenwald	2
DominicMazzoni	BrianL.Enke	1
Kam-FaiWong	K.L.Kwok	1
Paul-AlexandruChirita	ClaudiuS.Firan	1
ShubhaU.Nabar	BhaskaraMarthi	1
YijianBai	ChangLuo	1
YunmingYe	XiaofeiXu	1
SriramMohan	ArijitSengupta	1
XiaopengXi	Sang-HeeLee	1
SayaV.Nagori	JonathanC.Yang	1
WangYong	LongboZhang	1
MatthiasSchubert	ArthurZimek	1
MehdiEssid	AbdelkaderB*tari	1
PadhraicSmyth	DavidNewman	1
SarvjeetSingh	JeffreyScottVitter	1
HuiXiong	Gy*rgyJ.Simon	1
GenovevaVargas-Solar	GennaroBruno	1
ShashiShekhar	JamesA.Shine	1
PhilipS.Yu	OlivierVerscheure	1
MarcosSalganicoff	KazunoriOkada	1
SamLightstone	MaheswaranSurendra	1
YaochunHuang	SamYuanSung	1
IreneKotsia	IoannisPitas	1
MattCulver	KunDeng	1
StephenChi-faiChan	KeiShiuHo	1
TatjanaScope	SilkeEckstein	1
MatthiasSchubert	Hans-PeterKriegel	5
RajendraBose	LucMoreau	1
Kam-FaiWong	HoChungWu	1
ShiweiTang	LingWu	1
RalphKrieger	BorisGlavic	1
YingXu0002	MarcusFontoura	1
KunZhang	IanDavidson	1
JayantR.Haritsa	A.Kumaran	1
YangLiu	JosiahPoon	1
TorstenGrust	MauricevanKeulen	2
J.L.RodaGarc*a	FranciscoVargasRuiz	1
RonnyLempel	MichaelHerscovici	1
XiangyangLan	LarsBackstrom	1
GaryM.Weiss	BiancaZadrozny	1
YuniXia	ReynoldCheng	1
JinpingZheng	ArnoldP.Boedihardjo	1
HolgerBast	DebapriyoMajumdar	1
YingqiXu	GailMitchell	1
YongYang	ShamkantB.Navathe	1
YannisTheodoridis	MyraSpiliopoulou	1
HuanLiu	HaixunWang	1
MarcelKarnstedt	Kai-UweSattler	2
ShariqBashir	AbdulRaufBaig	1
ByronJ.Gao	BoazBen-Moshe	1
Zhi-HuaZhou	DaoqiangZhang	1
FernandoPereira0002	Al*pioM*rioJorge	1
Suh-YinLee	Fang-FeiKuo	2
FaizCurrim	CurtisE.Dyreson	1
IlyaVladimirskiy	BernhardSeeger	1
YumingOu	JiaruiNi	1
KaiMingTing	FeiTonyLiu	1
SharadMehrotra	QiZhong	1
GeorgeA.Mihaila	ChristianA.Lang	1
TingLiu	HaixiangGuo	1
StevenP.Callahan	HuyT.Vo	2
ZhihaiWang	SiweiLuo	1
ClaireLeschi	BernhardPfahringer	1
JohannesGehrke	BiswanathPanda	1
FrankK.H.A.Dehne	AndrewRau-Chaplin	1
JenniferWidom	AlonY.Halevy	2
TamMinhTran	PeterJ.Haas	3
HeliHiisil*	HeikkiMannila	1
JohannChristophFreytag	HeikoM*ller	1
SabineLoudcherRabas*da	RiadhBenMessaoud	1
ZivBar-Yossef	RonnyLempel	1
RiccardoRosati	MarcoRuzzi	1
RichardKing	NavenduJain	1
PeishenQi	PaeaLePendu	1
EstherRyvkina	AnuragMaskey	1
MuhammadAtifTahir	JimE.Smith	1
HongqinFan	AndrewFoss	1
NanTang	JiefengCheng	1
JianliangXu	DikLunLee	1
LichengJiao	LiZhang	1
YiFang	NagendraSingh	1
KevinSmathers	HarumiA.Kuno	1
TerranLane	R.BharatRao	1
YuchunTang	Yan-QingZhang	1
KeishiTajima	KatsumiTanaka	2
ZhengxinChen	YiPeng	3
SuvritSra	ArunC.Surendran	1
SebastianMichel	DeboraDonato	1
SinjaeKim	KyubumWee	1
PhilippeSelo	HenriqueAndrade	1
K.L.Kwok	HoChungWu	1
StefanBrecheisen	MartinPfeifle	1
ZhiyongHuang	HuaLu	1
BertramLud*scher	AnneH.H.Ngu	1
GautamDas	DimitriosGunopulos	2
Maria-EstherVidal	BenSnyder	1
RanWolff	KanishkaBhaduri	1
MarioAntonioletti	DavePearson	1
MarcosMen*rguezTortosa	Jes*sS*nchezCuadrado	1
BalakrishnaR.Iyer	AmrElAbbadi	1
WeiWang0010	JanPrins	2
RizosSakellariou	AnastasiosGounaris	1
SimonJ.Cox	DenisA.Nicole	1
UlfLeser	LukasFaulstich	1
Myoung-HoKim	KiYongLee	1
PeterR.Pietzuch	MemaRoussopoulos	1
SusanMalaika	AmyKrause	1
MasashiToyoda	MasaruKitsuregawa	1
PeerKr*ger	AlexeyPryakhin	5
RoyGr*nmo	Arne-J*rgenBerre	1
DaeWoongRhee	ByounghoSong	1
RobertH.Deng	FengBao	1
NeilR.Smalheiser	ClementT.Yu	1
MattWelsh	JonathanLedlie	1
BasitShafiq	ArjmandSamuel	1
WeiHong	ShawnR.Jeffery	1
YongShi	RongLiu	1
EmanueleSantos	Cl*udioT.Silva	2
RicardoA.Baeza-Yates	ClaudineSantosBadue	1
RobertJ.Calin-Jageman	PaulS.Katz	1
RogerS.Barga	BrianF.Cooper	1
SangeetaDoraiswamy	LathaS.Colby	1
SharadMehrotra	DmitriV.Kalashnikov	1
LauraM.Haas	JayavelShanmugasundaram	1
YanSong	Li-RongDai	1
UtkarshSrivastava	JeffreyF.Naughton	1
PanosK.Chrysanthis	KirkPruhs	2
ZifangHuang	XiaofengZhu	1
ZhenHuaLiu	MuralidharKrishnaprasad	1
SureshVenkatasubramanian	BengChinOoi	1
TharamS.Dillon	ElizabethChang	5
SunitaSarawagi	NickKoudas	1
MichaelJ.Carey	AnilMalkani	1
SuratnaBudalakoti	JoshuaSpiegel	1
SenthilPeriaswamy	JinboBi	1
SteveKelling	DanielFink	1
GiovanniDaSanMartino	FabioAiolli	1
PhilipS.Yu	JiefengCheng	1
Kyu-YoungWhang	Hyo-SangLim	1
SouripriyaDas	GeorgeEadon	1
WeeSunLee	DellZhang	1
HuaWang	HongHu	1
SharmaChakravarthy	RamanathanBalachandran	1
SvenPuhlmann	FelixNaumann	1
ShengchunDeng	JoshuaZhexueHuang	1
SongWang	SamratGanguly	1
TerranLane	JinboBi	1
SachindraJoshi	KrishnaPrasadChitrapura	1
I-JenChiang	Chun-ChihLiao	1
JimMelton	DavePearson	1
UmeshwarDayal	KevinSmathers	1
XiaofangZhou	HengTaoShen	1
RaghuRamakrishnan	Bee-ChungChen	4
ShigekiYokoyama	KimikoMatsuoka	1
YingLu	XinXu	1
DominicMazzoni	DennisDeCoste	1
JunHong	DavidA.Bell	1
WeiFan	IanDavidson	3
ShinYoungKwon	SangHoLee	1
Min-JaeLee	Il-YeolSong	1
VladimirCherkassky	QiLi	1
ZhengChen	ShuichengYan	1
ChandanK.Reddy	BalaRajaratnam	1
UlrichWagner	RalphSchlapbach	1
TakashiKobayashi	MakotoKataigi	1
FatihEmek*i	AzizGulbeden	1
BarbaraCatania	AlbertoBelussi	1
NieYu	Dong-HongJi	1
KenC.K.Lee	JianliangXu	2
ThomasDoggett	BenjaminCichy	1
LucasScharenbroich	DominicMazzoni	1
ShyamK.Gupta	IndiraMeshram	1
LisaFong	LiChen	1
YaronKanza	BennyKimelfeld	1
HaoHe	HaixunWang	1
JonathanLedlie	JeffreyShneidman	1
F.Alcojor	DanielMeziat	1
WagnerMeiraJr.	AdrianoVeloso	2
MichaelC.Burl	DennisDeCoste	1
JessicaLin	EamonnJ.Keogh	1
PaoloMissier	AlunD.Preece	1
RaffaelePerego	FrancescoBonchi	1
HanyuLi	GaoCong	1
StefanManegold	K.SjoerdMullender	1
JeffreyF.Naughton	AhmedAyad	1
RongShe	AdaWai-CheeFu	1
TamMinhTran	NimrodMegiddo	2
IhabF.Ilyas	AshrafAboulnaga	2
ErginElmacioglu	DongwonLee	1
SoonYoungJung	Sang-WonKang	1
TobiasRiemenschneider	MaximSchwarzkopf	1
SujeethThirumalai	DouglasBrewer	1
SunilJigyasu	AnilMalkani	1
NickPinto	EdlenoSilvadeMoura	1
XuanZheng	DavidWalker	1
JimCordes	GregoryJ.Sharp	1
SouravS.Bhowmick	AixinSun	1
JiaLi	DhirajJoshi	1
RainerGemulla	PhilippR*sch	1
GerhardWeikum	DebapriyoMajumdar	1
XiaohuaZhou	HyoilHan	1
ZhengChen	BenyuZhang	5
NoriakiKuwahara	HiromiItohOzaku	1
SudiptoGuha	NickKoudas	1
YueXu	Sheng-TangWu	1
RicardoA.Baeza-Yates	LilianaCalder*n-Benavides	1
Ren*eJ.Miller	PaoloPapotti	1
TatsuyaMori	AtsushiKobayashi	1
WangKayNgai	ChunKitChui	1
TakahikoIto	MasashiShimbo	2
PranayJain	PanagiotisG.Ipeirotis	1
KevinSmathers	JyotirmayaNanda	1
YunpengXu	XingYi	1
YannisE.Ioannidis	GeorgiaKoutrika	1
JianjunZhou	J*rgSander	1
SusanPaulsen	JinzeLiu	1
JyotirmayaNanda	HarumiA.Kuno	1
XinLi	NawaazAhmed	1
Ee-PengLim	DavidTaniar	1
YufeiTao	NikosMamoulis	1
RogerZimmermann	Chi-NgaiWan	1
KenUeno	Dah-JyeLee	1
LucMoreau	IanT.Foster	1
CristinaCachero	CoralCalero	1
SelcukAya	JimCordes	1
NiinaHaiminen	HeliHiisil*	1
SongWang	DanielJ.Dougherty	1
RalfKlinkenberg	MartinScholz	1
KienA.Hua	HaoCheng	1
O.Martin	BenoitM.Macq	1
YingLu	AnthonyK.H.Tung	1
JieChen	HuidongJin	3
OlivierVerscheure	MichailVlachos	1
TorstenGrust	JanRittinger	2
YingLiu	AihuaLi	1
PeterT.Wood	GeorgePapamarkos	1
JayantaBasak	D.V.S.Ravikant	1
ShuzhenNong	BenyuZhang	2
SayaV.Nagori	AriD.Brooks	1
NivioZiviani	ClaudineSantosBadue	1
JunYuan	ChangzhouWang	1
NobuhisaUeda	KosukeHashimoto	1
YuqingWu	ArijitSengupta	1
PeterOwotoki	FriedrichMayer-Lindenberg	1
Hung-MingChen	Hui-LingHuang	1
Wang-ChienLee	JianliangXu	4
SongWang	MingzhuWei	1
VicentePelechano	JavierMu*oz	1
ShiweiTang	LizhengJiang	1
StavrosHarizopoulos	DineshManocha	1
GoviGovindarajan	ArjenP.deVries	1
GuoyangShen	GuangFeng	1
JinboBi	JianmingLiang	1
ThomasSeidl	IraAssent	2
TomohiroYoshihara	RyoTaguchi	2
RaviKumar	AndrewTomkins	4
PhilipS.Yu	ArisAnagnostopoulos	2
NanDu	LiutongXu	1
RichCaruana	CristianBucila	1
YijianBai	PeiyaLiu	1
SomchaiChatvichienchai	MizuhoIwaihara	1
YangZhang	SamuelMadden	1
FrancescoParisi	BettinaFazzinga	1
XiangjiHuang	MiaoWen	1
YannisTheodoridis	AkriviVlachou	1
XiangJi	C.LeeGiles	1
SouravS.Bhowmick	SandeepPrakash	1
StevenJ.M.Jones	ObiL.Griffith	1
YufeiTao	TianXia	1
SoumyadebMitra	MarianneWinslett	1
JaideepSrivastava	BamshadMobasher	1
XiangdongZhou	BaileShi	1
RunpingQi	MarcusFontoura	1
RebeccaBraynard	CarlaSchlatterEllis	1
ShawnR.Jeffery	GustavoAlonso	1
ZimingZhuang	SilviuCucerzan	2
PeterBailey	BrettMatson	1
SriramRaghavan	EserKandogan	1
MuraliMani	HongSu	1
Ugur*etintemel	Jeong-HyonHwang	1
Kwang-SikChung	Chong-SunHwang	1
ShusakuTsumoto	HidetoYokoi	1
WitoldLitwin	PeterTsui	1
GeorgePapamarkos	AlexandraPoulovassilis	1
MoonBaeSong	KwangJinPark	2
JayavelShanmugasundaram	AlanJ.Demers	1
KenUeno	EamonnJ.Keogh	1
LingLiu	KekeChen	2
JosianeXavierParreira	GerhardWeikum	1
ThomasPhan	RaduSion	1
Yi-TingLai	KeWang	1
YunboCao	HangLi	1
S*ndorH*man	NielsNes	1
JiuyongLi	JieChen	1
KevinWilkinson	KeiYuasa	1
Yiu-mingCheung	MarkJunjieLi	1
MuraliMani	MingJiang0003	2
LimsoonWong	GuimeiLiu	1
RichardD.SissonJr.	ElkeA.Rundensteiner	1
RaresVernica	NickKoudas	1
RobertGwadera	HeikkiMannila	1
RajeevMotwani	KameshMunagala	1
H.V.Jagadish	DiveshSrivastava	1
KatsumiKanasaki	KaoruMaeda	1
PalomaD*az	LauraMontellsHiguero	1
YueXu	RichiNayak	1
StefanManegold	JanFlokstra	1
HuanHuo	BoNing	1
LinQiao	AmrElAbbadi	1
SudeeptBhatnagar	RaufIzmailov	1
QiZhang	LeonardMcMillan	1
KaiSimon	GeorgLausen	1
ShiyongLu	AdrianE.Platts	1
HuidongJin	ChristineM.O'Keefe	1
MariosHadjieleftheriou	EamonnJ.Keogh	1
JinboBi	ChandraKambhamettu	1
YvonneMorrow	JiaruiNi	1
PanagiotisPapapetrou	GaryBenson	1
AnuragGarg	AlbertoMontresor	1
NadavEiron	MarcusFontoura	1
WeiminTong	QiangYe	1
EduardoFern*ndez-Medina	Bel*nVela	1
JohannesGehrke	JayavelShanmugasundaram	2
WolfgangMay	OliverFritzen	3
MariosHadjieleftheriou	ArisAnagnostopoulos	1
BaileShi	AdaWai-CheeFu	2
Hahn-MingLee	Chia-HsinHuang	1
DongwonLee	Byung-WonOn	1
ParagAgrawal	OmarBenjelloun	1
NickKoudas	BengChinOoi	2
PeterK.Campbell	AlanHerschtal	1
MohammedJaveedZaki	MarcosAndr*Gon*alves	1
T.S.Jayram	ShivakumarVaithyanathan	1
OliverFritzen	ErikBehrends	3
KevinS.Beyer	AndreyBalmin	1
YoonhoPark	PhilippeSelo	1
TharamS.Dillon	HenryTan	3
MingyingZhao	JunZhao	1
TimosK.Sellis	DimitriTheodoratos	1
Ay*aAzginHintoglu	AliInan	1
MengHu	JiongYang	1
XiaodanSong	Ching-YungLin	1
XiaoqingZheng	HuajunChen	1
SimonC.K.Shiu	JamesN.K.Liu	1
LauraChiticariu	BogdanAlexe	1
Svein-OlafHvasshovd	J*rgenL*land	1
L.PaulChew	BiswanathPanda	1
MuthiahChettiar	AnandBhaskar	1
MicheleMelchiori	DeniseSalvi	1
TharamS.Dillon	J.WennyRahayu	1
RogerS.Barga	HillaryCaituiro-Monge	1
NataliaMarquez	LouiqaRaschid	1
KonstantinosStamos	AntonisSidiropoulos	1
JureLeskovec	HanghangTong	1
Hans-PeterKriegel	FlorianVorberger	1
TiffanyDohzen	MichaelStonebraker	1
QiongLuo	DyceJingZhao	1
LeiZhang	JohnK.Debenham	1
KaiYu	Hans-PeterKriegel	1
Tzung-PeiHong	Ching-YaoWang	1
SusanMalaika	MarioAntonioletti	1
TatsuoTsuji	LiBei	1
ShenghuoZhu	MitsunoriOgihara	1
YaronKanza	SaraCohen	1
JeffreyXuYu	HaixunWang	4
GangWang	FrederickH.Lochovsky	1
MatthiasBender	GerhardWeikum	3
MorHarchol-Balter	AdamWierman	1
VincentTo-YeeNg	StephenChi-faiChan	1
NeriusTradisauskas	DaliaTiesyte	1
ShoushenYang	DrewDitto	1
YingXu0002	RinaPanigrahy	1
TharamS.Dillon	AmandeepS.Sidhu	1
ZimingZhuang	JamesZeWang	1
ChristianB*hm	AlexeyPryakhin	3
YingXing	StanleyB.Zdonik	1
ShivakumarVaithyanathan	RajasekarKrishnamurthy	1
SongtingChen	K.Sel*ukCandan	3
MasashiToyoda	HiroshiOno	1
JunYang0001	HaoHe	1
NikilWale	GeorgeKarypis	1
MartinEster	GabrielaMoise	1
MaryF.Fern*ndez	DavidWalker	1
MichaelJ.Franklin	MatthewDenny	2
MarcoMaggini	AugustoPucci	1
PaulB.Kantor	DeborahSilver	1
KuoZhang	Juan-ZiLi	1
Hui-LingHuang	Chih-HungHsieh	1
JenniferWidom	ChrisHayworth	1
MingyingZhao	LichengJiao	1
XinLi	FuchunPeng	1
GiovanniDaSanMartino	AlessandroMoschitti	1
MirekRiedewald	ManuelCalimlim	1
HanLiu	AnthonyJ.Bonner	1
XingSun	SusanPaulsen	1
ZheDang	ShuohaoZhang	1
UpendraV.Chaudhari	DeepakS.Turaga	1
XiaodanSong	Ming-TingSun	1
UlfLeser	JohannChristophFreytag	1
DanielGmach	AlfonsKemper	1
Jean-DavidHsu	AlbertSutojo	1
MiaoWen	AijunAn	1
LucioGoglia	CristianDumitrescu	1
Han-ShenHuang	Chun-NanHsu	1
VenkatesanT.Chakaravarthy	HimanshuGupta	1
YanshengLu	LeiZou	1
YongZhang	LizhuZhou	2
RadaChirkova	ManolisGergatsoulis	1
KimihiroYamamoto	KeisukeIshibashi	1
JohannesA*falg	AlexeyPryakhin	3
WeifengSu	FrederickH.Lochovsky	3
ZimingZhuang	C.LeeGiles	1
RamyEltarras	MohamedY.Eltabakh	1
RobLesslie	NorazwinBuang	1
Ming-SyanChen	Jiun-LongHuang	1
HeikkiMannila	AristidesGionis	6
YannisTheodoridis	ReneSchult	1
LawrenceGibbons	DanielRiley	1
SebastianMichel	PeterTriantafillou	2
LeiTang	HuanLiu	1
JuanTrujillo	EmilioSoler	1
ShengMa	HaixunWang	1
ArturasMazeika	AndrejTaliun	1
NicolasRoper	JuttaA.M*lle	1
MarcosAndr*Gon*alves	AdrianoVeloso	1
TerranLane	JianmingLiang	1
YueWang	GregButler	1
PaoloPapotti	LucianPopa	1
SoujanyaVadapalli	JayantaBasak	1
DoinaPrecup	BeibeiZou	1
JialieShen	AnneH.H.Ngu	1
PeterKunath	MartinPfeifle	2
HakanFerhatosmanoglu	GuadalupeCanahuate	2
Jia-YuPan	AgmaJ.M.Traina	1
WeiLi	RubaoLi	1
XiaoyanLi	ChunChen	1
MukeshK.Mohania	HimanshuGupta	1
CyrusShahabi	AliKhoshgozaran	1
ChunKitChui	BenKao	1
XiaojingYuan	XiangshangLi	1
PhilipS.Yu	JunYang0001	1
ZengyouHe	XiaofeiXu	1
VolkerMarkl	VijayshankarRaman	2
UtkarshSrivastava	RajeevMotwani	1
RicardoA.Baeza-Yates	DavidF.Nettleton	1
WeiZhang	ClementT.Yu	1
RichiNayak	LaurieBuys	2
LinGuo	AnandBhaskar	1
LingLiu	HuaYan	1
RichardT.Snodgrass	FaizCurrim	1
WynneHsu	MinghuaZhang	1
MichaelHerscovici	MarcusFontoura	1
YongGao	OsmarR.Za*ane	1
PhilipS.Yu	JeffreyXuYu	3
SureshVenkatasubramanian	BingTianDai	1
LisaAmini	ChitraVenkatramani	1
FengYan	ChengLuo	1
JimengSun	ChristosFaloutsos	3
MassimilianoAlbanese	AngeloChianese	1
StefanB*ttcher	CharlesL.A.Clarke	1
HongxingHe	ChristineM.O'Keefe	1
MohammedManiruzzaman	CarolinaRuiz	1
ShipengYu	KaiYu	1
RafaelBerlangaLlavori	IsmaelSanz	1
SamahJamalFodeh	Pang-NingTan	1
JiuyongLi	GrantDaggard	1
StephanSchosser	BodoVogt	1
FabioAiolli	AlessandroMoschitti	1
Tzung-PeiHong	Shian-ShyongTseng	1
PavelDmitriev	DavidA.Lifka	1
SoujanyaVadapalli	MichaelReichert	1
TanApaydin	AliSamanTosun	1
SrinivasanParthasarathy	ChaoWang	3
RobLesslie	MichaelJ.Hill	1
JosianeXavierParreira	DeboraDonato	1
SanjayChawla	BavaniArunasalam	2
See-KiongNg	JinChen	1
MarcWichterich	ChristophBrochhaus	1
SoujanyaVadapalli	D.V.S.Ravikant	1
ShengZhang	AmitChakrabarti	1
ShuZhang	AhChungTsoi	1
ShiweiTang	DongqingYang	3
Wei-kengLiao	NanJiang	1
Sang-WonKang	Ki-SikKong	1
VincenzoMinei	RobertoGoglia	1
Zhongfei(Mark)Zhang	BoLong	1
MengxuLiu	KotagiriRamamohanarao	1
SreeramBalakrishnan	GaneshRamakrishnan	1
RicardoMardales	GeorgeNagy	1
NisheethShrivastava	JohnHershberger	1
HaiboHu	DikLunLee	2
XiaodanZhang	IllhoiYoo	1
MichaelK.Ng	JoshuaZhexueHuang	1
YiannisKanellopoulos	ChristosMakris	1
MoonBaeSong	Ki-SikKong	2
LawrenceB.Holder	DianeJ.Cook	2
HeikkiMannila	AnttiUkkonen	1
MinWang	ChristianA.Lang	1
ToshiroKubota	JinboBi	1
YufeiTao	ShuigengZhou	1
MichelGoraczko	BretHull	1
HariSundaram	BelleL.Tseng	1
LarsE.Olson	JeffreyM.Bradshaw	1
YiFang0003	Hyun-WooCho	1
TerranLane	MarcosSalganicoff	1
MahbubHassan	AixinSun	1
H.V.Jagadish	CheeYongChan	2
VishalS.Batra	CalistoZuzarte	1
KotagiriRamamohanarao	KeithMarsolo	1
XueminLin	JianXu	1
NickKoudas	CalistoZuzarte	1
XiaoxinYin	JiaweiHan	1
MingFan	KotagiriRamamohanarao	1
Seung-wonHwang	KevinChen-ChuanChang	1
MaithiliNarasimha	GeneTsudik	1
LiWei	JohnHandley	1
JohnW.S.Liu	BillO'Farrell	1
MelanieOsl	BernhardTilg	1
NormanW.Paton	JimSmith	1
J*rgenKr*mer	DimitrisPapadias	1
DachengTao	ChristosFaloutsos	1
Zo*Lacroix	TerryGaasterland	1
V*clavL*n	ProdromosMalakasiotis	1
NicholasJ.Pioch	JohnO.Everett	1
YenelYildirim	OlgaPapaemmanouil	2
HamidPirahesh	GuyM.Lohman	1
MassimilianoRuffolo	AndreaTagarelli	1
NarenRamakrishnan	ChrisBailey-Kellogg	1
SongtingChen	DivyakantAgrawal	3
ShivakumarVaithyanathan	DouglasBurdick	1
LeiZhang	DebbieZhang	1
PeiyaLiu	FushengWang	3
VelenLiang	SamuelMadden	1
KunLiu	ChrisGiannella	1
WenJin	WeiWang0010	1
BerthierA.Ribeiro-Neto	ArturZiviani	1
NachiketaSahoo	JamieCallan	1
YarivMatia	LeonPortman	1
LeonidReyzin	FeifeiLi	1
MartinTheobald	DebapriyoMajumdar	1
TimmEuler	IngoMierswa	1
StefanManegold	JanRittinger	2
ManfredHauswirth	Kai-UweSattler	1
ShawnBowers	AnneH.H.Ngu	1
MarcoRuzzi	DomenicoLembo	1
RichardD.SissonJr.	DavidC.Brown	1
MichaelK.Ng	DavidW.Cheung	1
EdwardY.Chang	BelleL.Tseng	1
WilliamPerrizo	TaufikAbidin	1
Wen-YuanKu	Ming-HaoHung	1
MartaMattoso	EduardoBezerradaSilva	1
QigangGao	HaiH.Wang	1
SachindraJoshi	RaghuKrishnapuram	2
Ming-SyanChen	Bi-RuDai	1
MiloradKrneta	LiminLin	1
SandrodaSilvaCamargo	Jo*oFranciscoValiati	1
JiaweiHan	ChengXiangZhai	1
WolfgangLehner	SebastianRichly	1
MartaMattoso	GabrielaRuberg	1
VanaKalogeraki	DimitriosGunopulos	2
TatsuyaMori	RyoichiKawahara	1
JosephM.Hellerstein	FrederickReiss	2
VladimirCherkassky	JiepingYe	1
KenjiTakeda	DenisA.Nicole	1
MuthiahChettiar	FengShao	1
WenJin	RongGe	1
YingZhu	RajshekharSunderraman	1
KeiYuasa	JyotirmayaNanda	1
MartinScholz	IngoMierswa	1
MohandBoughanem	LobnaHlaoua	1
ArtMunson	AlexandruNiculescu-Mizil	1
NinaMishra	KrishnaramKenthapadi	1
NormanMay	Carl-ChristianKanne	1
VanaKalogeraki	ThemisPalpanas	1
TadashiOhmori	MamoruHoshi	1
MarcFriedenberg	JamesZeWang	1
YanchangZhao	SiweiLuo	1
MichaelGrossniklaus	CorsinDecurtins	1
RuiWang0002	GermanShegalov	1
JanaBauckmann	FelixNaumann	1
ArunK.Majumdar	AbhinavSrivastava	1
SungRanCho	DiveshSrivastava	1
BiancaSchroeder	ArunIyengar	2
LawrenceGibbons	GregoryJ.Sharp	1
W.JohnWilbur	LiseGetoor	1
TimFinin	DanielOlmedilla	1
JunRao	HetalThakkar	1
PadhraicSmyth	JonHutchins	1
RoniRomano	LiorRokach	1
ThomasSeidl	MarcWichterich	1
ItzhakFadida	BennyKimelfeld	1
ShumingShi	Ji-RongWen	1
XuanyangXie	XiLi	1
KentarouKido	HiroyukiKitagawa	1
MatthewJ.Rattigan	MarcMaier	1
W.P.Weiss	JiaLi	1
ThomasB.Hodel-Widmer	MichaelH.B*hlen	1
YuanchenHe	RajshekharSunderraman	1
HaixunWang	ChangLuo	1
JunYang0001	AminVahdat	1
ValentinKuznetsov	SelcukAya	1
RajasekarKrishnamurthy	JenniferL.Beckmann	1
WanxiaXie	SushilK.Prasad	1
YaochunHuang	WeiliWu	1
ZhenZhang	Seung-wonHwang	1
Hj*rdisHoff	Arne-J*rgenBerre	1
MuraliMani	DrewDitto	1
TimmEuler	MartinScholz	1
SophoinKhy	HiroyukiKitagawa	1
Vicen*Soler	JordiRoig	1
ThomasDoggett	DominicMazzoni	1
M.Glittum	CesarePautasso	1
SeokIlSong	JaeSooYoo	1
MohamedF.Mokbel	Chi-YinChow	1
XiaofangZhou	KeDeng	1
YuqingWu	JonathanKlinginsmith	1
SachindraJoshi	GaneshRamakrishnan	1
ShengGuo	JunhyongKim	1
YipingLi	SamChao	1
OliviuGhica	GoceTrajcevski	1
YingZhang	FlipKorn	1
ZhangMing-Wei	ZhangBin	1
ShijiSong	BinGao	1
XingsenLi	GuangliNie	1
YingLu	WeiWang0010	1
MeghanaDeodhar	JoydeepGhosh	1
SunnyAggarwal	AlekhAgarwal	1
LaurieBuys	JanLovie-Kitchin	2
SumeiXu	RichiNayak	1
SantiagoMeli*	CristinaCachero	1
JaganSankaranarayanan	HoumanAlborzi	1
Inha*maNevesFerraz	AnaCristinaBicharraGarcia	1
Yen-KuangChen	ChristopherJ.Hughes	1
SuzanneM.Embury	R.MarkGreenwood	1
NorazwinBuang	NianjunLiu	1
WeiLiu	MohammedBennamoun	1
WuWeimin	WangRonggui	1
PaulWatson	NormanW.Paton	1
MartaPrim	Jes*sCerquides	1
WeiChu	ShirishKrishnajShevade	1
RajshekharSunderraman	HaoTian	1
PrasannaPadmanabhan	PercyBernedo	1
JuliaDeneva	JohannesGehrke	1
HaiyingWang	AlbanChesneau	1
YingjieTian	NaiyangDeng	1
JinShieh	EamonnJ.Keogh	1
OlivierHenchiri	NathalieJapkowicz	1
ManLungYiu	KitHungCheng	1
RonenFeldman	MohammedJaveedZaki	2
TimOates	JoeCatalano	1
JeffCerwinske	CarlosRojas	1
MingJiang0003	LingWang	2
TokWangLing	JiahengLu	1
RamaswamyHariharan	NaliniVenkatasubramanian	1
XuehuaShen	BinTan	1
LauraIrinaRusu	J.WennyRahayu	1
Ming-SyanChen	Chi-YaoTseng	1
Seung-CheonBaek	MoonJeungJoe	1
JianHuang0002	HongyuanZha	1
OliverPo	K.Sel*ukCandan	1
RajeevMotwani	JenniferWidom	1
XiangZhang	WeiWang0010	1
MirekRiedewald	BiswanathPanda	1
UmeshwarDayal	FabioCasati	1
JeyashankherRamamirtham	GrahamCormode	1
SimelaTopouzidou	MichaelPantazoglou	1
EugeneJ.Shekita	AndreiZ.Broder	1
LisaAmini	HenriqueAndrade	1
VijayshankarRaman	GarretSwart	1
MicheleMelchiori	DevisBianchini	1
ZhengxinChen	YongShi	3
RubaoLi	MinghongZhou	1
IbrahimKorpeoglu	BurcinBostan-Korpeoglu	1
Kian-LeeTan	AnthonyK.H.Tung	3
PrasanRoy	D.V.S.Ravikant	1
HowardE.Michel	DajunWang	1
VinayakR.Borkar	MichaelJ.Carey	3
Sang-WonKang	Kwang-SikChung	1
QiongLuo	BingshengHe	1
TaoLi	MitsunoriOgihara	1
PedroCoutinho	M*rioJ.Silva	1
ZimingZhuang	MarcFriedenberg	1
PavelDmitriev	DanielRiley	1
DanielFleder	BalajiPadmanabhan	1
ThierryCruanes	MohamedZa*t	1
PhuongNguyen	KanishkaBhaduri	1
ShyongK.Lam	AdamLaPitz	1
OmidMadani	DavidPennock	1
ErkaySavas	AlbertLevi	1
ZhenyuChen	JianpingLi	1
InderpalNarang	DanielC.Zilio	1
StratosPapadomanolakis	JulioC.L*pez	1
RolfLak*mper	LonginJanLatecki	1
MuratAliBayir	AhmetCosar	1
QianQian	LizhuZhou	1
WilfredNg	AoyingZhou	1
PreethaAppan	BelleL.Tseng	1
Kyu-YoungWhang	Jae-GilLee	1
YannisPapakonstantinou	EmiranCurtmola	1
DivyakantAgrawal	ArsanySawires	1
MartaMattoso	AlexandreA.B.Lima	1
YanRuiHuang	JosiahPoon	1
WenweiXue	QiongLuo	1
ThomasKabisch	RonaldPadur	1
OliverPo	ArsanySawires	1
DivyakantAgrawal	BalakrishnaR.Iyer	1
VincentC.S.Lee	CliftonPhua	1
GabrielaRuberg	AlexandreAndrade	1
TaoXiong	JiepingYe	2
WeiFan	KunZhang	2
MaximSchwarzkopf	AlexanderZeiss	1
JanO.Pedersen	HinrichSch*tze	1
WeiminMa	KeWang	1
Jo*oM.B.Cavalcanti	AltigranSoaresdaSilva	1
ChengXiangZhai	AzadehShakery	1
LucaDeRosa	CristianDumitrescu	1
MohamedS.Kamel	KhaledM.Hammouda	1
SelcukAya	MirekRiedewald	1
XiaopengXiong	WalidG.Aref	1
JohannGamper	ChristianS.Jensen	1
RuchaneewanSusomboon	JacobD.Furst	1
TaoLi	LiuzhongYang	1
ShirleyCohen	KarlW.Schulz	1
ThomasSeidl	ChristophBrochhaus	1
Hsiao-DongChiang	ChandanK.Reddy	1
SergeyMelnik	PhilipA.Bernstein	2
MassimoFranceschet	EnricoZimuel	1
TakashiWashio	AkiraMogi	1
Yi-ChengTu	SunilPrabhakar	2
YenKaowNg	TakeshiShinohara	1
KeDeng	HengTaoShen	1
MartaMattoso	FernandaAraujoBai*o	1
WeizhenChen	Mian-YunChen	1
LucianPopa	AlinDeutsch	1
TamMinhTran	MarcelKutsch	3
MorHarchol-Balter	ErichM.Nahum	2
YimingMa	DmitriV.Kalashnikov	1
WangKayNgai	ReynoldCheng	1
WeiminXiao	BingLiu	2
LawrenceGibbons	ChristopherD.Jones	1
LouiqaRaschid	JensBleiholder	1
HitoakiSakamoto	AtsushiKobayashi	1
RaymondChi-WingWong	KeWang	1
JuanTrujillo	Il-YeolSong	1
C.T.HowardHo	ArielFuxman	1
MarioPiattini	JuanTrujillo	1
BengChinOoi	AoyingZhou	1
RakeshAgrawal	FrankLeymann	1
ChangLuo	CarloZaniolo	1
FanYang0002	AlanJ.Demers	1
RajBhatnagar	HaiyunBian	1
KangRyoungPark	JunoChang	1
TysonCondie	RaghuRamakrishnan	1
Johann-AdolfM*ller	FrankLemke	1
MarcoMesiti	IsmaelSanz	1
ThomasHeinis	Hj*rdisHoff	1
ManHonWong	ChiHongCheong	1
PascalFrossard	ArisAnagnostopoulos	1
MartaPrim	JordiRoig	1
WagnerMeiraJr.	MohammedJ.Zaki	1
BadrishChandramouli	AminVahdat	1
TimothyRoscoe	BoonThauLoo	1
YaochunHuang	HuiXiong	1
SameepMehta	S.Srinivasan	1
PaulGinsparg	DariaSorokina	1
KanishkaBhaduri	KamalikaDas	1
YingChen	E.Sithirasenan	1
YoungChulPark	PeterScheuermann	1
YunSingKoh	RichardA.O'Keefe	1
KensukeOhta	HaruoYokota	1
YutakaKabutoya	SatoshiOyama	1
ShivakumarVaithyanathan	EserKandogan	1
Cl*udioT.Silva	CarlosEduardoScheidegger	2
YijianBai	FushengWang	1
DivyakantAgrawal	AzizGulbeden	1
PankajK.Agarwal	JunyiXie	1
PetrosDrineas	MichaelW.Mahoney	2
O.Rodr*guez	A.Viana	1
VibhutiS.Sengar	MichaelReichert	1
StephenFisher	ShirleyCohen	1
EricP.Xing	AgmaJ.M.Traina	1
SourashisRoy	SoujanyaVadapalli	1
AssafSchuster	ArieLeizarowitz	1
WeiWang0009	PengWang	1
SimonasSaltenis	ChristianS.Jensen	1
M*nicaMarrero	GonzaloG*nova	1
MichaelJ.Franklin	GustavoAlonso	1
NormanMay	GuidoMoerkotte	1
PeishenQi	DejingDou	1
IbrahimKorpeoglu	AdnanYazici	1
FengChen	ChengqiZhang	1
CuipingLi	AnthonyK.H.Tung	1
YangLiu	YanRuiHuang	1
SabahCurrim	RichardT.Snodgrass	1
DavidA.Lifka	AndersRyd	1
RamaswamyHariharan	DmitriV.Kalashnikov	1
PhilippR*sch	AnjaKlein0001	1
DmitryLychagin	DanielEngovatov	1
ShefaliSinghal	CarlosRueda	1
ZhiyongPeng	YuanShi	1
ShiyingHuang	GeoffreyI.Webb	1
RinaPanigrahy	RajeevMotwani	1
ShantKarakashian	JihadBoulos	1
MarioPiattini	EsperanzaMarcos	1
ZhijieChen	Mian-YunChen	1
BertramLud*scher	AmarnathGupta	1
ManuelCalimlim	ChristopherD.Jones	1
KarstenM.Borgwardt	JohannesA*falg	1
Shyan-MingYuan	Ping-JerYeh	1
RalfRantzau	EvimariaTerzi	1
JamesBailey	EricBae	1
PeerKr*ger	InaM*ller-Gorman	1
PadhraicSmyth	AlexanderT.Ihler	1
MirekRiedewald	ChristopherD.Jones	1
QianQian	JianyongWang	1
JunyiXie	BadrishChandramouli	1
SatyanarayanaR.Valluri	KamalakarKarlapalem	2
SoumenChakrabarti	ArpitMathur	1
HendrikBlockeel	AmandaClare	1
ZhenbangRong	JuhuaChen	1
SarvjeetSingh	ReynoldCheng	1
SonnyVaupel	MichaelCammert	1
DavidHawking	BrettMatson	1
SunKim	AmitSaple	1
MargheritaBerardi	MarcellaAttimonelli	1
WynneHsu	See-KiongNg	1
WeiPeng	ChrisH.Q.Ding	1
VincenzoMoscato	MassimilianoAlbanese	1
SachinThatte	KanadDixit	1
QiangYang	JunYan	2
JayendraVenkateswaran	DeepakLachwani	1
YiChen	QihongShao	1
RaghuRamakrishnan	DavidR.Musicant	1
SunilChoenni	HenkErnstBlok	1
RossGayler	KateSmith-Miles	1
RobertH.Warren	FrankWm.Tompa	1
Sang-HeeLee	MichailVlachos	1
KeWang	AdaWai-CheeFu	2
LidanShou	JinxiangDong	1
NadaLavrac	GemmaC.Garriga	1
JiuyongLi	HuaWang	2
StanleyB.Zdonik	EstherRyvkina	1
MarianneWinslett	AndrzejUszok	1
RafiAhmed	DineshDas	1
GuozhengXiao	Dong-HongJi	1
ValentinKuznetsov	ManuelCalimlim	1
GeorgianaIfrim	FabianM.Suchanek	1
XiaohuaHu	Il-YeolSong	1
XueminLin	KeDeng	1
LeanderSchietgat	HendrikBlockeel	1
PaulBrown	BertholdReinwald	1
MichaelPantazoglou	GeorgeAthanasopoulos	1
OlfaNasraoui	JeffCerwinske	1
WeiWang0009	JianXu	2
NickPinto	JulianaFreire	1
SebastianMichel	ChristianZimmer	1
NuweeWiwatwattana	DiveshSrivastava	1
Yi-HongChu	Jen-WeiHuang	1
YuZhang	XiaoqingZheng	1
WeidaZhou	LichengJiao	1
YoshiteruNakamori	Minh-HoangLe	1
KunGao	IppokratisPandis	1
JasmineNovak	AndrewTomkins	1
StefanieRinderle	AndreasWombacher	1
TomoeSugihara	ParagAgrawal	1
PascalPoncelet	Fran*oisTrousset	1
PhilipS.Yu	JianYin	1
Andr*G.R.Balan	AgmaJ.M.Traina	1
XiangZhou	BoxuanZhai	1
UtzWestermann	RameshJain	1
TeLi	QihongShao	1
YongYu	RuiLi	1
GenovevaVargas-Solar	ChristineCollet	1
PhilipS.Yu	JeffreyF.Naughton	1
JimMelton	AmyKrause	1
PilarParra	MartinKnoblauch	1
PauloMartinsEngel	LuisOt*vioAlvares	1
JiZhang	HaiH.Wang	1
QiZhang	JanPrins	1
PedroPereiraRodrigues	Jo*oPedroPedroso	1
WeixuanXu	JianpingLi	1
GavinM.Bierman	ErikMeijer	1
GrantDaggard	AshleyW.Plank	1
SunnyAggarwal	SoumenChakrabarti	1
ZhijieChen	QileChen	1
Yang-SaeMoon	Il-YeolSong	1
MalikMagdon-Ismail	BrandeisHill	1
LucaDeRosa	AntonioAlbano	1
NathanSeeley	JeffreyM.Bradshaw	1
StanleyB.Zdonik	AnuragMaskey	1
SioIongAo	JoshuaZhexueHuang	1
SvenHelmer	Carl-ChristianKanne	1
RiccardoRizzo	AlfonsoUrso	1
RebeccaBraynard	AdamSilberstein	3
DariaSorokina	DanielFink	1
CaetanoTrainaJr.	AgmaJ.M.Traina	2
IanT.Nabney	DharmeshM.Maniyar	1
Ji-RongWen	FeiXing	1
NiinaHaiminen	EllaBingham	1
SamuelMadden	DavidJ.DeWitt	1
MartinTheobald	HolgerBast	1
ShankarPal	JoeXavier	1
Young-KooLee	Yang-SaeMoon	1
IdaG.Sprinkhuizen-Kuyper	EvgueniN.Smirnov	1
SourashisRoy	JayantaBasak	1
R.BharatRao	GlennFung	1
ShengWang	LuQin	1
ManolisGergatsoulis	FotoN.Afrati	1
YoungheeLee	SaehoonKang	1
VaniaBogorny	BartKuijpers	1
Wang-PinHsiung	Jun'ichiTatemura	3
Wei-YingMa	Ji-RongWen	4
DonaldKossmann	CarstenBinnig	1
Il-YeolSong	Hyo-SangLim	1
XuehuaShen	QiaozhuMei	1
MinhoSung	JunXu	1
YihaoZhang	MehmetA.Orgun	1
Jes*sM.P*rez	IbaiGurrutxaga	1
PhilipA.Bernstein	JohnE.Churchill	1
ZujiaXu	BillP.Buckles	1
PhilipA.Bernstein	PaoloCappellari	1
TakashiKobayashi	KensukeOhta	1
Vicen*Soler	Jes*sCerquides	1
ShaileshJoshi	SabahCurrim	1
YanifAhmad	OlgaPapaemmanouil	3
NickPinto	Jo*oM.B.Cavalcanti	1
YifengZheng	ShengGuo	1
QigangGao	JiZhang	1
H.V.Jagadish	BengChinOoi	3
MarcusFontoura	EugeneJ.Shekita	1
MengxuLiu	HongjianFan	1
Ji-RongWen	HuanLiu	1
KaushikChakrabarti	JiaweiHan	1
MarioPiattini	IgnacioGarc*aRodr*guezdeGuzm*n	1
RizosSakellariou	AlvaroA.A.Fernandes	1
EvangelosDellis	AkriviVlachou	1
GuorenWang	BoNing	1
MichelGoraczko	KevinChen	1
KhanhVu	HaoCheng	1
ZimingZhuang	DhirajJoshi	1
YongShi	XingsenLi	2
XueminLin	WeiWang0011	1
JohnPearson	GeraldMadlmayr	1
Sang-HyukLim	Ki-ChangKim	1
RalfSchenkel	DebapriyoMajumdar	1
LalanaKagal	DanielOlmedilla	1
JieZhang	CarlosRueda	1
MohammedManiruzzaman	AparnaS.Varde	1
TomoeSugihara	OmarBenjelloun	1
MingDong	FarshadFotouhi	1
RalphSchlapbach	EtzardStolte	1
StephenA.Krawetz	AdrianE.Platts	1
JulianWinter	BaihuaZheng	2
SankarVirdhagriswaran	GordonDakin	1
ValentinKuznetsov	JohannesGehrke	1
RaghuRamakrishnan	DavidE.Gay	1
DechangChen	Chang-TienLu	1
KarlAberer	DonaldKossmann	1
GregoryJ.Sharp	DavidA.Lifka	1
RonnyLempel	NadavEiron	1
TharamS.Dillon	OmarKhadeerHussain	1
YingXing	Ugur*etintemel	1
JunyiXie	HaiYu	1
KunLiu	KamalikaDas	1
WagnerMeiraJr.	MarcosAndr*Gon*alves	1
Kam-FaiWong	JeffreyXuYu	1
ShichaoZhang	JeffreyXuYu	1
ZengLian	ChaoLiu0001	1
EdwardY.Chang	ArunQamra	1
KangRyoungPark	Hyeon-JoongYoo	1
YuchangGong	XuanyangXie	1
YannisTheodoridis	ThemisPanayiotopoulos	1
StratosPapadomanolakis	DavidR.O'Hallaron	1
YannisSismanis	PaulBrown	1
SethuramBalajiKodeswaran	AnupamJoshi	1
WolfgangMay	DanielSchubert	1
JaideepSrivastava	ColinDeLong	1
QuinnHart	CarlosRueda	1
JingGao	HaibinCheng	3
SusanMalaika	DavePearson	1
RobertoBattiti	AlbertoMontresor	1
RamKeralapura	GrahamCormode	1
RyoTaguchi	HaruoYokota	3
VanjaJosifovski	ShubhaU.Nabar	1
PeterA.Boncz	NielsNes	1
VijayGopalakrishnan	PeterJ.Keleher	1
RaghuRamakrishnan	JudeW.Shavlik	1
YannisPapakonstantinou	MichalisPetropoulos	1
KenC.K.Lee	HongVaLeong	1
EvgueniN.Smirnov	A.M.Kaptein	1
WilsonWong	WeiLiu	1
JeffreyF.Naughton	DavidJ.DeWitt	1
ToddJ.Green	PhilipA.Bernstein	1
VictorC.S.Lee	DikLunLee	1
YunZhou	W.BruceCroft	1
MahbubHassan	Ee-PengLim	1
JeremyRogers	ColinPuleston	1
VetleI.Torvik	ClementT.Yu	1
RuchaneewanSusomboon	DanielaStanRaicu	1
ShuqiaoGuo	BengChinOoi	1
XinYao	PeterTi*o	1
YenelYildirim	Ugur*etintemel	2
XiuliMa	LizhengJiang	1
VagelisHristidis	MichailVlachos	1
XingXie	Wei-YingMa	1
HoumanAlborzi	HananSamet	1
MingruiWu	KaiYu	1
WyattT.Clark	JamesC.Costello	1
MohamedFaridElhawary	MirekRiedewald	1
TerenceCritchlow	AnneH.H.Ngu	1
ChristianBaumgartner	BernhardTilg	1
Yo*lleS.Maarek	IdoGuy	1
DeepayanChakrabarti	AndrewTomkins	1
StephenB.Pope	MirekRiedewald	1
PatrickHurley	BradBenton	1
WilliamY.Arms	SelcukAya	1
VladimirBychkovsky	HariBalakrishnan	1
TranT.Hoai	ErwinLeonardi	1
VaniaBogorny	SandrodaSilvaCamargo	1
PeterJ.Haas	NimrodMegiddo	2
YifengShao	DingyiHan	1
XiaofeiXu	ShuigengZhou	1
TaneliMielik*inen	PauliMiettinen	1
XiangJi	HongyuanZha	1
GaganAgrawal	ChrisJermaine	1
JouniK.Sepp*nen	HeikkiMannila	1
SandeepTata	JamesS.Friedman	1
JitBiswas	FelixNaumann	1
Zo*Lacroix	BarbaraA.Eckman	1
WeiqiangLin	WarwickGraco	1
SatoshiKouno	RyutaroIchise	1
JaapSuermondt	GeorgeForman	1
Tie-YanLiu	Huai-YuanYang	1
Seung-HwanLim	HeejinPark	1
StanislavBarton	PavelZezula	1
KangLi	DouglasBrewer	1
StefanoLonardi	LiWei	1
RolfLak*mper	MarcSobel	1
WeiZhuang	GrahamCormode	1
PeterJ.Haas	PaulG.Brown	1
NormanMay	AlexanderB*hm0002	1
TaneliMielik*inen	EvimariaTerzi	1
LeonidReyzin	GeorgeKollios	1
NormanMay	MatthiasBrantner	1
TaoLi	ShenghuoZhu	1
FernandoBicharraPinto	AnaCristinaBicharraGarcia	1
KeWang	BenjaminC.M.Fung	1
HuimingQu	AlexandrosLabrinidis	1
SenthilPeriaswamy	KazunoriOkada	1
TheophanoMitsa	HowardE.Michel	1
ArielSepulveda	A.CharlesThomas	1
Chun-NanHsu	Bo-HouYang	1
MatthiasBrantner	AlexanderB*hm0002	1
MuhammadA.Ahmad	AnkurTeredesai	1
YvonneMorrow	YanchangZhao	1
Hyun-SookLee	Gye-JeongKim	1
PascualQueralt	ArturBoronat	1
WeiFan	PhilipS.Yu	1
MehdiSharifzadeh	AliKhoshgozaran	1
Hans-PeterKriegel	ChristianB*hm	2
SvenGroppe	StefanB*ttcher	1
RobertW.P.Luk	KeiShiuHo	1
RajasekarKrishnamurthy	JeffreyF.Naughton	1
KennyQiliZhu	JoxanJaffar	1
JamesBailey	ChristopherLeckie	1
NiinaHaiminen	HeikkiMannila	1
SergioFlesca	FrancescoParisi	1
LotharJ*nsch	FrankKlawonn	1
GeorgeKollios	FeifeiLi	2
JeffreyM.Bradshaw	GianlucaTonti	1
PanosK.Chrysanthis	MohamedAly	1
HowardJ.Hamilton	GuichongLi	1
SongHan	ElizabethChang	1
XiaoleiLi	DiegoKlabjan	1
MaheswaranSurendra	AdamJ.Storm	1
ShichaoZhang	JingliLu	1
MingLi	HongSu	1
GangWang	Dit-YanYeung	1
MarcoMaggini	MarcoGori	1
JieChen	DamienMcAullay	3
AlexandrosKalousis	AdamWoznica	2
XuesongMa	BeibeiZou	1
LucianoBarbosa	JulianaFreire	1
ShusakuTsumoto	HidenaoAbe	3
FabioA.Gonz*lez	CarlosRojas	1
ManLungYiu	DavidW.Cheung	1
YuWang0011	JianyongWang	1
QiangYang	HuaLi	1
AlessandroSperduti	AlessandroMoschitti	1
XinqiangZuo	XiaomingJin	2
WilliamPerrizo	AmalPerera	1
HongyiHu	HariBalakrishnan	1
XinYan	DaweiSong	1
LixinShi	Jian-YunNie	1
TaneliMielik*inen	AristidesGionis	3
TokWangLing	MinHu	2
PhilipS.Yu	CharuC.Aggarwal	1
ZsoltTivadarKardkov*cs	DomonkosTikk	1
StephenBay	RohitKumar	1
HuaiyuZhu	EserKandogan	1
PeterBailey	DavidHawking	1
SantiagoMeli*	CoralCalero	1
RaghuKrishnapuram	KrishnaPrasadChitrapura	1
TaoXiong	QiLi	1
MarcusFontoura	JohnMcPherson	1
MarcelKarnstedt	KatjaHose	1
WilliamY.Arms	JohannesGehrke	1
LingpengYang	GuozhengXiao	1
JeHyunCho	GeumJiCha	1
ChenLi	AnthonyK.H.Tung	1
StephanSchosser	KlemensB*hm	1
GoceTrajcevski	AnnikaHinze	1
NadavEiron	JohnMcPherson	1
SimelaTopouzidou	Arne-J*rgenBerre	1
HuidongJin	HongxingHe	3
MarcoPatella	IlariaBartolini	1
WeiWang0010	QiZhang	1
MasayoshiAritsugi	DamdinsurenAmarmend	1
ZhigangZhang	WeijiaJia	1
YueWang	GuangWang	1
VincentS.Tseng	Chun-HaoChen	1
SucharitaGopal	JunchangJu	1
DineshDas	AllisonW.Lee	1
SteveA.Chien	AshleyDavies	1
MarkusG.Anderle	KrishnaKumaraswamy	1
RaghuRamakrishnan	MinosN.Garofalakis	1
Zhi-HuaZhou	Hong-BinDai	1
TorstenSuel	AlexanderMarkowetz	1
OmidMadani	DennisDeCoste	1
UtkarshSrivastava	StephenWright	1
YanZhang	XindongWu	1
BarbaraCatania	AnnaMaddalena	1
JohannesGehrke	AndersRyd	1
PavelDmitriev	MirekRiedewald	1
Zhi-HuaZhou	De-ChuanZhan	1
Yi-LingChen	Ming-SyanChen	1
ShiyongLu	CuiLin	1
XiaoyanZhu	LiZhuang	1
XiongfengPan	MinghuaZeng	1
ToonCalders	BartGoethals	2
ElisaBertino	ArifGhafoor	1
SimonKamenkovich	AnatEyal	1
MiguelA.Laguna	JulioCesarSampaiodoPradoLeite	1
Wei-YingMa	GuangFeng	1
Sang-WonKang	KwangJinPark	1
Wei-YingMa	Huai-YuanYang	1
Yi-HungWu	ArbeeL.P.Chen	1
JanStruyf	AmandaClare	1
JulioC.L*pez	DavidR.O'Hallaron	1
TorstenSteinbach	JayantaBasak	1
TingLiu	KhalidEl-Arini	1
KrithiRamamritham	AnilBahuman	1
TobiasRiemenschneider	AlexanderZeiss	1
ShengWang	JunZhang	1
WenshengWu	EduardC.Dragut	1
HongyiHu	BretHull	1
SharmilaSubramaniam	DimitrisPapadopoulos	1
MonaWong-Barnum	MaryannE.Martone	1
HongSu	ElkeA.Rundensteiner	1
XiLi	ShouhongWan	1
H.V.Jagadish	AoyingZhou	1
WalterA.Kosters	JoostN.Kok	1
UmeshwarDayal	KevinWilkinson	1
RaduSion	InderpalNarang	1
QiaozhuMei	DongXin	2
OlfaNasraoui	MyraSpiliopoulou	1
YingZhu	RobertJ.Calin-Jageman	1
NicuD.Cornea	BingBai	1
R.BharatRao	KazunoriOkada	1
YoshiharuIshikawa	SophoinKhy	1
JianshengHuang	JeffreyF.Naughton	1
Mar*aJ.Escalona	JavierJ.Guti*rrez	1
WalidG.Aref	MohamedF.Mokbel	1
NeoklisPolyzotis	EmmanuelD.Pontikakis	1
HuidongJin	DamienMcAullay	3
SucharitaGopal	EricD.Kolaczyk	1
W.ScottSpangler	JeffreyT.Kreulen	1
WilliamJ.Merline	DominicMazzoni	1
HongyuanZha	GordonSun	1
RobertoGoglia	LucaDeRosa	1
ZhangMing	PengQingsong	1
JamesFord	FilliaMakedon	3
O.Garc*a	IgnacioGarc*a	1
SouravS.Bhowmick	QiankunZhao	3
FrankK.H.A.Dehne	E.Sithirasenan	1
XiangshangLi	IanDavidson	1
WeiWang0011	JianXu	1
DavidChu	ArsalanTavakoli	1
EmiranCurtmola	AlinDeutsch	2
PaulBarford	LeiChen0003	1
Ya-TiPeng	Ching-YungLin	1
RyenW.White	DianeKelly	1
StevenJ.M.Jones	ByronJ.Gao	1
SaehoonKang	In-YoungKo	1
KunLiu	HillolKargupta	2
JanHegewald	FelixNaumann	1
AnishDasSarma	AlonY.Halevy	2
DanJiang	BanafshehVaezian	1
WeiyiMeng	EduardC.Dragut	2
KevinChen	HariBalakrishnan	1
ManuShukla	JianpingZhang	1
Xiang-SunZhang	Hong-WeiLiu	1
MirekRiedewald	MingshengHong	1
MarkCheng-EnnHsieh	ArbeeL.P.Chen	1
JamesJ.Lu	Chia-HsinHuang	1
SilkeEckstein	AndreasKupfer	1
XindongWu	ShichaoZhang	1
SpirosPapadimitriou	MichailVlachos	1
NanCao	HaoLv	1
HongHu	AshleyW.Plank	1
ElkeA.Rundensteiner	DrewDitto	1
MuthiahChettiar	LinGuo	1
KiichiIto	KenichiHorie	1
WilsonC.Hsieh	RobPike	1
OlgaPapaemmanouil	JohnJannotti	3
JanuszR.Getta	AnitaDani	1
PawelPlacek	DimitriTheodoratos	1
PaulWatson	AnastasiosGounaris	1
SrujanaMerugu	ClaudiaPerlich	1
WeidaZhou	LiZhang	1
WilliamY.Arms	ChristopherD.Jones	1
IsabelleMarshall	ChrisEdgar	1
WeiWang0011	FlipKorn	1
JunLi	JianLu	1
LinLi	GeYu	1
RonaldGreeley	DominicMazzoni	1
PingLing	ChunguangZhou	1
LingZhuang	HonghuaDai	1
ChristopherD.Carothers	BouchraBouqata	1
XiaohuiYu	CalistoZuzarte	2
WarwickGraco	MehmetA.Orgun	1
MarcelaGenero	CristinaCachero	1
LinQiao	BalakrishnaR.Iyer	1
Wen-SyanLi	InderpalNarang	1
FatihEmek*i	DivyakantAgrawal	1
ZeinaKoteiche	JihadBoulos	1
RamyaRangarajan	JaideepSrivastava	1
JerryKiernan	FrankLeymann	1
YannisManolopoulos	AlexandrosNanopoulos	1
VaniaBogorny	Jo*oFranciscoValiati	1
TerryGaasterland	BenSnyder	1
JunZhang	JeffreyXuYu	1
Wei-YingMa	BoZhang	1
Tzung-PeiHong	Chun-HaoChen	1
SrinathShankar	DavidJ.DeWitt	1
MagedEl-Sayed	ElkeA.Rundensteiner	1
HaiyingWang	FranciscoAzuaje	1
OmidMadani	NathanGood	1
KristenLeFevre	DavidJ.DeWitt	2
SteveKelling	DariaSorokina	1
SusanB.Davidson	ShengGuo	1
RichCaruana	MohamedFaridElhawary	2
TranT.Hoai	SanjayKumarMadria	1
HaraldHolz	AndreasDengel	1
JasonZhang	DaymondLing	1
YiLu	ShiyongLu	1
RichardKing	ChitraVenkatramani	1
SunilJigyasu	SachinThatte	1
ZaiqingNie	FeiWu	1
NathanielMartin	JohnHandley	1
DavidNewman	ChaitanyaChemudugunta	1
RafiAhmed	AllisonW.Lee	1
YuniXia	JeffreyScottVitter	1
PhilipA.Bernstein	AlanNash	1
OsmarR.Za*ane	Chi-HoonLee	1
KristinaLisaKlinkner	BingLiu0003	1
FlorianDaniel	FedericoMicheleFacca	1
FanYang0002	AnandBhaskar	1
MaximSchwarzkopf	J*rgenKr*mer	1
K.Sel*ukCandan	ArsanySawires	1
SayaV.Nagori	LawrenceH.Reeve	1
NazimH.Madhavji	CharlesX.Ling	1
MichaelD.Gordon	LiWang	1
HenkErnstBlok	ErikLeertouwer	1
OmarBenjelloun	AlonY.Halevy	2
JunfengWu	HongqinFan	1
Ee-PengLim	AixinSun	1
ShuqiaoGuo	H.V.Jagadish	1
Jau-MinWong	FurenXiao	1
SpirosPapadimitriou	PhilipS.Yu	4
LauraMontellsHiguero	IgnacioAedo	1
MichaelJ.Carey	KanadDixit	1
RajeevRastogi	HonestyC.Young	1
XueLi	XingzhiSun	1
Wei-YingMa	ShaozhiYe	1
ShijiSong	HangLi	1
StefanB*ttcher	RitaSteinmetz	1
ClaudineSantosBadue	ArturZiviani	1
RajasekarKrishnamurthy	AlanHalverson	1
JeffreyF.Naughton	GangLuo	1
NagendraSingh	DavidT.Potere	1
RobertGrossman	GregoryPiatetsky-Shapiro	2
Zhi-HuaZhou	Xu-YingLiu	2
PeterT.Wood	AlexandraPoulovassilis	1
MohammedManiruzzaman	ElkeA.Rundensteiner	1
Seung-TaekPark	OmidMadani	1
SamirKhuller	JensBleiholder	1
WagnerMeiraJr.	FernandoMour*o	1
MichelGoraczko	AllenMiu	1
Wook-ShinHan	StephanEwen	1
JensBleiholder	FelixNaumann	1
SimelaTopouzidou	Hj*rdisHoff	1
IgnacioGarc*a	DanielMeziat	1
DavidStirling	DannySoetanto	1
YassineLassoued	OmarBoucelma	1
JohnF.Roddick	DenisedeVries	1
ShouyangWang	KinKeungLai	1
JianXu	BaileShi	2
V*roniqueBenzaken	KimNguyen	1
GrahamJ.Williams	ChrisKelman	1
NobuhisaUeda	HiroshiMamitsuka	1
HanghangTong	AgmaJ.M.Traina	1
MichaelCammert	BernhardSeeger	3
TamaraA.Schwimmer	AriD.Brooks	1
YogeshSimmhan	DennisGannon	1
ZhengZhang0002	Ren*eJ.Miller	1
MartinPfeifle	Hans-PeterKriegel	3
JiayuanHuang	DengyongZhou	1
HuaWang	FatenKhalil	1
TatKeongLoh	SatyaSreenivasan	1
SimonC.K.Shiu	JennieL.C.Lam	1
P.Anandan	C.Mohan	1
SilkeEckstein	BrittaSt*rmann	1
RichCaruana	ArtMunson	2
JianzhongLi	DongDongZhang	1
NathanielMartin	LiWei	1
TerenceCritchlow	BertramLud*scher	1
YiyuYao	KenKonkel	1
AlMamunurRashid	AdamLaPitz	1
ThomasHeinis	AphroditeTsalgatidou	1
ShigeoSugimoto	AtsuyukiMorishima	1
TomasHrycej	ChristianManuelStrobel	1
YiZhuang	LeiChen0002	1
LeonardMcMillan	JanPrins	1
StephenBay	KrishnaKumaraswamy	1
JackeyNg	BenKao	1
YiannisKanellopoulos	ThimiosDimopulos	1
SamuelMadden	HongyiHu	1
NormanW.Paton	JimMelton	1
UtkarshSrivastava	MarcelKutsch	1
PeterR.Pietzuch	JeffreyShneidman	1
MarcoZaffalon	GiorgioCorani	1
LijuanZhang	JianWen	1
JingHua	CuiLin	1
J*r*meSim*on	ChristopherRe	2
MatthiasRenz	Hans-PeterKriegel	5
LiutongXu	BaiWang	1
ThomasHeinis	RoyGr*nmo	1
WolfgangLehner	AnjaKlein0001	1
S.S*nchez	A.Viana	1
Woong-KeeLoh	Wook-ShinHan	1
RadaChirkova	GangGou	1
TimK.Cocx	JeroenS.deBruin	1
LawrenceGibbons	DavidA.Lifka	1
ThomasDoggett	RebeccaCasta*o	1
TiejunHuang	CharlesX.Ling	1
SamLightstone	AdamJ.Storm	1
SalvatoreOrlando	ClaudioLucchese	2
Kian-LeeTan	CheeYongChan	2
JianHuang0002	IsaacG.Councill	1
NormanW.Paton	DavePearson	1
HuaWang	GrantDaggard	1
KuoZhang	CanLiu	1
SusanaMontero	PalomaD*az	1
PhuChienNguyen	AkiraMogi	1
SimonJ.Cox	KenjiTakeda	1
OlfaNasraoui	CarlosRojas	2
VladimirBychkovsky	AllenMiu	1
YoshiharuMaeno	KenichiHorie	2
PetrosManiatis	BoonThauLoo	1
ZografoulaVagena	PhilipS.Yu	1
GunjanGupta	AlexanderLiu	1
ToshiyukiAmagasa	KentarouKido	1
MinWang	KevinChen-ChuanChang	1
MarianoP.Consens	JohnW.S.Liu	1
BasitShafiq	ArifGhafoor	1
SouravS.Bhowmick	JinyanLi	2
YangDu	EvangelosKanoulas	1
ManuelCalimlim	DanielRiley	1
JeffreyXuYu	DavidW.Cheung	1
I.V.Ramakrishnan	ChangZhao	1
MichaelH.B*hlen	ArturasMazeika	1
LiseGetoor	GregoryPiatetsky-Shapiro	2
WesleyM.Hochachka	DariaSorokina	1
SunilPrabhakar	RahulShah	1
JingWang0007	BanafshehVaezian	1
Wei-YingMa	LiGao	1
YifengZheng	SusanB.Davidson	3
ShefaliSinghal	QuinnHart	1
YongdaeKim	MarkShaneck	1
XiaoyuWang	MitchCherniack	1
YitzhakMandelbaum	MarkDaly	1
ShenghuaBao	RuiLi	1
YingXu0002	RajeevMotwani	1
RafaelBerlangaLlavori	GiovannaGuerrini	1
ThomasDoggett	SteveA.Chien	1
RobertoBasili	AlessandroMoschitti	1
JiaweiHan	AnthonyK.H.Tung	1
XiongfengPan	QingLiu	1
KazunoriOkada	JinboBi	1
SpyrosVosinakis	NikosPelekis	1
Wei-YingMa	QiankunZhao	1
VolkerTresp	ShipengYu	1
SeokJinIm	MoonBaeSong	1
PhilipBohannon	EimanElnahrawy	1
ThomasHeinis	MichaelPantazoglou	1
ShaorongLiu	FushengWang	2
DamienMcAullay	ChrisKelman	2
NikolayI.Nikolaev	EvgueniN.Smirnov	1
HuabeiYin	HuCao	1
Wei-TaChen	Ming-SyanChen	1
KarinBecker	CarenMoraesNichele	1
OmarKhadeerHussain	ElizabethChang	1
MinhoSung	AbhishekKumar	1
ShuzhenNong	JunYan	2
VikramGoyal	AnandGupta	1
JayavelShanmugasundaram	DinaBitton	1
BingTianDai	AnthonyK.H.Tung	1
ZengjianHu	RongGe	1
MehdiSharifzadeh	CyrusShahabi	2
LongbingCao	ChengqiZhang	2
YunboCao	BingLiu	1
RongHu	HuamingZhang	1
ShumingShi	FeiXing	1
NikosNtarmos	GerhardWeikum	2
JingBai	GuihongCao	1
OsmarR.Za*ane	AndrewFoss	1
J.L.RodaGarc*a	E.VictorS*nchezRebull	1
RiccardoTorlone	IvanPanella	1
WolfgangMay	ErikBehrends	3
WeiningQian	RongGe	1
RonnyLempel	EugeneJ.Shekita	1
ShefaliSinghal	MichaelGertz	1
RichardT.Snodgrass	KyriacosE.Pavlou	1
TomonobuOzaki	HitohiroShiozaki	1
ShengWang	BolinDing	1
JunRao	GuyM.Lohman	1
MirekRiedewald	LawrenceGibbons	1
RyoichiKawahara	KeisukeIshibashi	1
TonyFallon	DamienMcAullay	1
SimeonJ.Simoff	JohnGalloway	1
StephenA.Krawetz	ShiyongLu	1
MohammedJaveedZaki	LiseGetoor	2
SteffenKempe	JochenHipp	1
Tie-YanLiu	QiankunZhao	1
MariaCamilaNardiniBarioni	HumbertoLuizRazente	1
RiteshKumar	JimGray	1
WenshengWu	A.PrasadSistla	1
HidetoYokoi	HidenaoAbe	1
ZhengZhang	ShuigengZhou	2
NevinM.Darwish	DinaA.Said	1
LeiZhang0001	LeChen	1
RebeccaN.Wright	GeethaJagannathan	2
RunpingQi	EugeneJ.Shekita	1
ThemisPalpanas	SharmilaSubramaniam	1
Sang-WonKang	MoonBaeSong	1
KefengDeng	FengJing	1
RiccardoRizzo	MichaelR.Berthold	1
SanghoKim	JinSoungYoo	1
YingLi	NingLiu	2
Il-YeolSong	HyoilHan	1
MichaelFlaster	EimanElnahrawy	1
SpiridonBakiras	DimitrisPapadias	1
MichaelCammert	AlexanderZeiss	1
GregoryPiatetsky-Shapiro	ChabaneDjeraba	2
TraianMariusTruta	BinduVinay	1
NataliaMarquez	Maria-EstherVidal	1
LawrenceGibbons	JimCordes	1
TheoH*rder	ChristianMathis	3
HaixunWang	Chang-ShingPerng	1
XiaoyuanWang	JianPei	2
TrevorN.Mansuy	RobertJ.Hilderman	1
ThimiosDimopulos	ChristosTjortjis	1
WilliamY.Arms	PavelDmitriev	1
YunboCao	JinWang	1
MatthiasRenz	AlexeyPryakhin	5
StevenJ.M.Jones	MartinEster	1
TomoeSugihara	ChrisHayworth	1
MyraSpiliopoulou	IreneNtoutsi	1
MirekRiedewald	JimCordes	1
YijianBai	CarloZaniolo	1
O.Rodr*guez	MartinKnoblauch	1
VictorLavrenko	AntonLeuski	1
LauraBright	DavidMaier	1
VivekNigam	RafaelPe*aloza	1
LaksV.S.Lakshmanan	DiveshSrivastava	1
HumbertoLuizRazente	AgmaJ.M.Traina	1
YujiMatsumoto	MasashiShimbo	2
XiaoyunHui	BoNing	1
LinGuo	FengShao	1
JamesBailey	ElsaLoekito	1
JiaweiHan	DiegoKlabjan	1
MichaelChau	KevinY.Yip	1
Ming-TingSun	Ching-YungLin	2
SharadMehrotra	NaveenAshish	1
Carl-ChristianKanne	AlexanderB*hm0002	1
Min-JaeLee	Hyo-SangLim	1
RichardF.Helm	DeeptKumar	1
KimutaiKimeli	JianzhongLi	1
SibelAdali	BrandeisHill	1
JavierMu*oz	CarlosCetina	1
RangaRajuVatsavai	ManishBhide	1
DineshManocha	AnastassiaAilamaki	2
SunilJigyasu	MichaelJ.Carey	1
AliKhoshgozaran	AliKhodaei	1
Shin'ichiWakabayashi	NoriyoshiYoshida	1
YifengShao	CongShi	1
LatanyaSweeney	BradleyMalin	1
LiuzhongYang	FeiWang	1
NatashaDrukh	LeonPortman	1
Fran*ois-MarieColonna	AbdelkaderB*tari	1
WolfgangLehner	ThomasLegler	1
SongcanChen	DaoqiangZhang	1
SteveKelling	MohamedFaridElhawary	1
Yi-TingLai	JasonZhang	1
MartaPrim	JosepSabria	1
YuSuzuki	BattuguldurLkhagva	1
YuguoLiao	YongZhang	1
ShubhaU.Nabar	OmarBenjelloun	1
SoujanyaVadapalli	PrasanRoy	1
Shinn-YingHo	Hung-MingChen	1
KrishnanPillaipakkamnatt	GeethaJagannathan	1
MarcBrette	BrunoRoustant	1
TimothyRoscoe	DavidE.Gay	1
YanchangZhao	LingzhiLiao	1
LawrenceGibbons	AndersRyd	1
XiaochunYang	LinLi	1
ShenghuaBao	JinWang	1
ChristosFaloutsos	AdrianoS.Arantes	1
JulianaFreire	CarlosEduardoScheidegger	2
LauraM.Haas	FranzFaerber	1
GeorgeEadon	EugeneInseokChong	1
TakayukiYumoto	KeishiTajima	1
Yen-KuangChen	SrinivasanParthasarathy	1
YoungheeLee	WoohyunKim	1
ShiwoongKim	DejingDou	1
TorstenGrust	PeterA.Boncz	2
SandeepMane	NishithPathak	1
PeterR.Pietzuch	MargoI.Seltzer	1
TheophanoMitsa	PaulJ.Fortier	1
SrihariPadmanabhan	SharmaChakravarthy	1
SurajitChaudhuri	RaghavKaushik	2
Wang-ChienLee	HongVaLeong	1
NieYu	GuodongZhou	1
MaheswaranSurendra	ChristianGarcia-Arellano	1
YannisPapakonstantinou	VagelisHristidis	1
PavanK.Chowdary	JayantR.Haritsa	1
PeterJ.Haas	BertholdReinwald	1
TongSun	NathanielMartin	1
ChavdarBotev	AnandBhaskar	1
LarsE.Olson	GianlucaTonti	1
RajeevMotwani	BhaskaraMarthi	1
ParagAgrawal	AnishDasSarma	1
RongZhang	Kian-LeeTan	1
SusanaMontero	IgnacioAedo	1
WeiWang0010	LeonardMcMillan	1
VanjaJosifovski	RinaPanigrahy	1
WenshengWu	ClementT.Yu	2
S.Muthukrishnan	FlipKorn	2
RangaRajuVatsavai	PrasanRoy	1
SatoshiOyama	ChiTian	1
InaM*ller-Gorman	Hans-PeterKriegel	1
FranciscoAzuaje	AlbanChesneau	1
Ugur*etintemel	OlgaPapaemmanouil	3
DenisedeVries	CarlMooney	1
XiaohuiYu	DiveshSrivastava	1
StephenChi-faiChan	RobertW.P.Luk	1
MarkoKrema	KatharinaProbst	1
DivyakantAgrawal	AmrElAbbadi	4
PilarParra	IgnacioGarc*a	1
JianminWang	Jia-GuangSun	1
EamonnJ.Keogh	DragomirYankov	1
V*roniqueBenzaken	DarioColazzo	1
MattWelsh	MargoI.Seltzer	1
GuorenWang	ChuanXiao	1
LouiqaRaschid	BarbaraA.Eckman	1
MikhailBilenko	BeenaKamath	1
SangeethaSeshadri	BrianF.Cooper	1
RussellGreiner	OsmarR.Za*ane	1
KyriakosMouratidis	DimitrisPapadias	2
Lee-FengChien	Chen-MingHung	1
Ki-SikKong	Chong-SunHwang	1
XiaoboZhou	VikramChandramohan	1
TiankaiTu	DavidR.O'Hallaron	1
YangLiu	MiaoWen	1
MarcoMesiti	GiovannaGuerrini	2
SandrodaSilvaCamargo	BartKuijpers	1
KathleenFisher	DavidWalker	1
DineshDas	AndrewWitkowski	1
VipinKumar	HuiXiong	1
Jos*A.Blakeley	AnilNori	1
GautamDas	AristidesGionis	1
WalterA.Kosters	TimK.Cocx	1
SenthilPeriaswamy	GlennFung	1
ShawnR.Jeffery	MichaelJ.Franklin	2
YangWang0007	MohamedS.Kamel	1
MichaelEckert	Fran*oisBry	1
Inha*maNevesFerraz	FernandoBicharraPinto	1
ShivakumarVaithyanathan	HuaiyuZhu	1
ShamikSural	AbhinavSrivastava	1
HyunWoongShin	DennisMcLeod	1
YanguZhang	MinYao	1
ShusakuTsumoto	MihoOhsaki	3
VishalKapoor	Fran*oisTrousset	1
S.S*nchez	IgnacioGarc*a	1
YannisManolopoulos	KonstantinosStamos	1
RoyGeorge	IbrahimKorpeoglu	1
NingYu	KhanhVu	1
YaoWu	Maria-EstherVidal	1
JerzyMarcinkowski	JanChomicki	1
AnthonyTomasic	AmitManjhi	1
CarlosA.Heuser	Andr*PriscoVargas	1
VassiliosS.Verykios	ArisGkoulalas-Divanis	1
ZhengzhengXing	DanWu	1
TatsuoTsuji	KenHiguchi	1
LeonidGlimcher	ChrisJermaine	1
MakotoKataigi	DaiKobayashi	1
SoujanyaVadapalli	RangaRajuVatsavai	1
Sang-WonKang	Chong-SunHwang	1
XueyuanZhou	ChunpingLi	2
VerenaKantere	DanZhao	1
S.Sudarshan	GautamDas	1
ShashankPandit	DuenHorngChau	1
MoonJeungJoe	Hyun-SookLee	1
WenJin	JiaweiHan	1
RichardF.Helm	NarenRamakrishnan	1
WolfgangLehner	AndrewRoss	1
WangKayNgai	BenKao	1
KanadDixit	AnilMalkani	1
VivekNigam	Lo*cRoyer	1
WeiWang0009	AdaWai-CheeFu	2
NickCraswell	HugoZaragoza	1
SouripriyaDas	EugeneInseokChong	1
Jun'ichiTatemura	DivyakantAgrawal	4
YueWang	LiqianZou	1
WynneHsu	Mong-LiLee	5
YuxiaYao	XueyanTang	1
OlivierBodenreider	AlbanChesneau	1
WeiZhang	VetleI.Torvik	1
IsmailHakkiToroslu	AhmetCosar	1
MinoruKanehisa	KiyokoF.Aoki-Kinoshita	1
PeterJ.Keleher	BobbyBhattacharjee	1
RomanSchmidt	MarcelKarnstedt	1
YutakaHirokawa	HitoakiSakamoto	1
K.Sel*ukCandan	Jun'ichiTatemura	4
ThorstenMeinl	ChristianBorgelt	1
DipanjanChakraborty	AnupamJoshi	1
YanifAhmad	Ugur*etintemel	3
WolfgangLehner	PeterJ.Haas	1
VanessaP.Braganholo	FernandaAraujoBai*o	1
ToshihikoYamasaki	KiyoharuAizawa	1
Ching-ChiHsu	Chien-YuChen	1
AliInan	AlbertLevi	1
NeoklisPolyzotis	MinosN.Garofalakis	1
MingjieZhu	Ji-RongWen	1
R.BharatRao	MarcosSalganicoff	2
EdwardK.F.Dang	DikLunLee	1
MichaelSchroeder	AlexanderKozlenkov	1
RajeevMotwani	AndreiZ.Broder	1
KarlAberer	AndrasFeher	1
MichaelChau	ChunKitChui	1
MaartenMarx	EnricoZimuel	1
GeoffreyI.Webb	DamienBrain	1
RunpingQi	MichaelHerscovici	1
JianhuaFeng	GuoliangLi	1
GihanDawelbait	AlexanderKozlenkov	1
GeorgeAthanasopoulos	Arne-J*rgenBerre	1
FengYu	BengChinOoi	1
HongHu	GrantDaggard	1
YiZhang0001	PhilipZigoris	2
YongShi	GangKou	3
SamratGanguly	RaufIzmailov	1
LarsSchmidt-Thieme	ChristinePreisach	1
MuraliMani	ElkeA.Rundensteiner	7
MircoNanni	FoscaGiannotti	1
VeeraraghavanVijayaraj	NealFeierabend	1
TaneliMielik*inen	GautamDas	1
PeterR.Pietzuch	MattWelsh	1
RongShe	KeWang	1
BelleL.Tseng	ArunQamra	1
MichaelGertz	CarlosRueda	1
Shinn-YingHo	Kuan-WeiChen	1
PatrickValduriez	BernardoMiranda	1
KalyanBeemanapalli	JaideepSrivastava	2
PeterBuneman	JamesCheney	1
JohannesGehrke	AlanJ.Demers	2
SanjayAgrawal	EricChu	1
PeterA.Boncz	AnastassiaAilamaki	1
YuniXia	SunilPrabhakar	1
AnandMeka	AmbujK.Singh	1
XueminLin	JiefengCheng	1
ThomasS.Huang	AtulyaVelivelli	1
TadeuszMorzy	RobertWrembel	1
P.Eng	LucBeaudoin	1
YingZhou	ChenWang	1
FengYu	AoyingZhou	1
FanDeng	DavoodRafiei	1
SubramanyamChitti	LiXiong	1
MarcelKarnstedt	AndreasJob	1
CaijieZhang	BenY.Zhao	1
VeeraraghavanVijayaraj	DavidT.Potere	1
RadaChirkova	FotoN.Afrati	1
XuweiLiang	CuiLin	1
LisaAmini	DeepakS.Turaga	1
NikosNtarmos	MatthiasBender	1
UmeshwarDayal	JyotirmayaNanda	1
ZhoujunLi	LijuanZhang	1
WanjingZhang	King-LupLiu	1
Jean-RochMeurisse	FabriceEstievenart	1
MutluMete	GalShafirstein	1
MuraliMani	DanielJ.Dougherty	1
TaneliMielik*inen	HeikkiMannila	3
YanRuiHuang	XiangjiHuang	1
JianweiLi	AlokN.Choudhary	1
Yang-SaeMoon	Kyu-YoungWhang	1
SeydaErtekin	LeventBolelli	1
AustinDonnelly	AntonyI.T.Rowstron	2
RyoTaguchi	MakotoKataigi	1
YuWang0011	LizhuZhou	1
MinosN.Garofalakis	MichaelJ.Franklin	1
ChristophSchmitz	BernhardGanter	1
ShyongK.Lam	AlMamunurRashid	1
KlausR.Dittrich	AbrahamBernstein	2
PritiPatil	JayantR.Haritsa	1
RangaRajuVatsavai	MichaelReichert	1
YannisE.Ioannidis	AlkisSimitsis	1
MingLi	ElkeA.Rundensteiner	2
ShankarPal	DraganTomic	1
Tam*sHorv*th	StefanWrobel	1
GeorgeKollios	ChingChang	1
Wei-bangChen	ChengcuiZhang	1
IraAssent	AndreaWenning	1
RicoWind	KennethHoukj*r	1
PedroDomingos	ParagSingla	1
XingsenLi	JunLi	1
JuanM.Vara	Bel*nVela	1
EtzardStolte	AttilaGyenesei	1
NathanSeeley	MarianneWinslett	1
XiaoyuanWang	BaileShi	2
RobertGwadera	AristidesGionis	1
MirekRiedewald	DariaSorokina	1
ChristopherOlston	BruceM.Maggs	1
MichaelPantazoglou	Hj*rdisHoff	1
SunitaSarawagi	ImranR.Mansuri	1
YiyaoLu	WeiyiMeng	1
SeokJinIm	Ki-SikKong	1
XiangshangLi	KunZhang	1
LoretoBravo	LeopoldoE.Bertossi	1
TomonobuOzaki	TakenaoOhkawa	3
VassiaPavlaki	ManolisGergatsoulis	1
TobiasRiemenschneider	ChristophHeinz	1
NickPinto	KaraneVieira	1
MarkusStumptner	GeraldQuirchmayr	1
VaniaBogorny	LuisOt*vioAlvares	1
YaZhang	StephenR.Holbrook	1
VenkateshGanti	RaghavKaushik	2
Jean-HuguesChauchat	Fran*oisPellegrino	1
JunoChang	HungKookPark	1
ManolisKoubarakis	ChristosTryfonopoulos	1
ZhengChen	NingLiu	3
YifengZheng	YiChen	2
KienA.Hua	KhanhVu	2
GeorgeAthanasopoulos	AphroditeTsalgatidou	1
SusanPaulsen	JanPrins	1
RobertGrossman	LiseGetoor	2
ThomasHofmann	ElisabethGeorgii	1
TatjanaScope	BrigitteMathiak	1
Wei-YingMa	FengJing	1
ElizabethChang	AmandeepS.Sidhu	1
JunoChang	DaeWoongRhee	1
VincenzoMoscato	AngeloChianese	1
DwightE.Nelson	ChihLai	1
Jos*IgnacioMart*n	JavierMuguerza	1
ReynoldCheng	RahulShah	1
YipingKe	JamesCheng	4
EvimariaTerzi	AristidesGionis	1
MarioAntonioletti	JimMelton	1
YanqingZhang	IllhoiYoo	1
ErikBehrends	DanielSchubert	1
SenZhang	JasonTsong-LiWang	1
WesleyM.Hochachka	DanielFink	1
YuHirate	HayatoYamana	2
WeiHong	AmolDeshpande	1
PauliMiettinen	AristidesGionis	1
JohnShepherd	BinCui	1
Dae-KiKang	AdrianSilvescu	2
SougataMukherjea	AnupamJoshi	1
RobertoGoglia	AntonioAlbano	1
UweR*hm	Thanh-MaiDiep	1
KurtDriessens	ClaireLeschi	1
OmarBenjelloun	JenniferWidom	3
ManuelCalimlim	JimCordes	1
MarkBrodie	HuiXiong	1
QiongLuo	LeiChen0002	1
MyraSpiliopoulou	BamshadMobasher	1
YongYu	BingLiu	1
MiguelA.Laguna	BrunoGonz*lez-Baixauli	1
P.C.Nagesh	AmitChandel	1
O.Rodr*guez	F.Alcojor	1
PanosVassiliadis	ManolisTerrovitis	1
MahadevanSubramanian	DanielC.Zilio	1
JiuyongLi	HuidongJin	1
YiFang	DavidT.Potere	1
MassimoFranceschet	LoredanaAfanasiev	1
S.S*nchez	O.Rodr*guez	1
MohamedA.Sharaf	AlexandrosLabrinidis	1
RobertoTrasarti	RaffaelePerego	1
RuomingJin	ChaoWang	1
ThomasPhan	RameshNatarajan	1
VolkerMarkl	NimrodMegiddo	2
SanjayKumarMadria	ErwinLeonardi	1
VagelisHristidis	HeasooHwang	1
YoonhoPark	ChitraVenkatramani	1
YunyueZhu	MohamedF.Mokbel	1
ChristopherOlston	AmitManjhi	1
TarekHamrouni	EngelbertMephuNguifo	1
Ching-HsiangTsai	Chen-MingHung	1
DaliaTiesyte	ChristianS.Jensen	1
RichardKing	PhilippeSelo	1
ElenaLazkano	BasilioSierra	1
MatthijsvanLeeuwen	ArnoSiebes	2
WynneHsu	JunmeiWang	1
VinayakR.Borkar	SujeetBanerjee	1
ChristopherD.Carothers	BoleslawK.Szymanski	1
Jia-YuPan	EricP.Xing	1
StephenB.Pope	L.PaulChew	1
XuehuaShen	JiaweiHan	1
JunYang0001	JeffreyXuYu	1
PhilippeCudr*-Mauroux	AndrasFeher	1
PaulJ.Kennedy	JustinLuu	1
DamienMcAullay	ChristineM.O'Keefe	1
SouravS.Bhowmick	SomchaiChatvichienchai	1
XinPei	LiutongXu	1
YongwhaChung	DaiheePark	1
PhilipBohannon	MichaelFlaster	1
ShengZhang	FilliaMakedon	3
RoyGeorge	AdnanYazici	1
ZhangBin	WeiWei-Jie	1
KunalPunera	AndreiZ.Broder	1
NanTang	JeffreyXuYu	2
PreethaAppan	HariSundaram	1
Chien-YuChen	Chen-MingHsu	1
SibelAdali	BouchraBouqata	1
VincenzoMinei	LucioGoglia	1
MarieO.Murray	AliBahrami	1
VishalS.Batra	DanielC.Zilio	1
MarieO.Murray	JunYuan	1
WataruSunayama	KatsutoshiYada	1
KalyanBeemanapalli	AmitBose	1
RemcoR.Bouckaert	EibeFrank	1
PeterChristen	KarlGoiser	1
WangKayNgai	MichaelChau	1
KarlW.Schulz	BradBenton	1
Wen-YuanKu	Shinn-YingHo	1
RoyGr*nmo	Hj*rdisHoff	1
MirkoSteinle	KarlAberer	1
YoshiharuMaeno	KiichiIto	1
MartinKnoblauch	DanielMeziat	1
LeoMark	ArjenP.deVries	1
NormanW.Paton	AnastasiosGounaris	1
PeerKr*ger	MatthiasRenz	5
MichaelPantazoglou	Arne-J*rgenBerre	1
MatthiasSchubert	ChristianB*hm	1
TahsinM.Kur*	ShirishTatikonda	1
ChristopherOlston	AnthonyTomasic	1
PeterScheuermann	AnnikaHinze	1
YokoKamidoi	Shin'ichiWakabayashi	1
MarioPiattini	EmilioSoler	1
LucianPopa0002	DavidChu	1
VincentS.Tseng	Chien-HsiangChen	1
FerencSzidarovszky	DomonkosTikk	1
StephenR.Holbrook	ChrisH.Q.Ding	1
StavrosHarizopoulos	NagaK.Govindaraju	1
ThomasPhan	InderpalNarang	1
JeffreyXuYu	HaoHe	1
MeihongZhu	JingranDai	1
HetalThakkar	CarloZaniolo	2
CesarePautasso	Arne-J*rgenBerre	1
KameshMunagala	JenniferWidom	1
XiaojingYuan	BillP.Buckles	1
RoyGr*nmo	MichaelPantazoglou	1
OliverPo	AmrElAbbadi	1
SalvatoreGaglio	GiuseppeDiFatta	1
UtkarshSrivastava	KameshMunagala	1
WilliamI.Grosky	MichaelD.Morse	1
ValentinKuznetsov	PavelDmitriev	1
SebastianMichel	NikosNtarmos	1
ShuichengYan	JunYan	1
ManuelMej*as	JavierJ.Guti*rrez	1
PredragRadivojac	MehmetM.Dalkilic	1
TrevorHastie	PingLi	1
RajasekarKrishnamurthy	HuaiyuZhu	1
XiaopengXi	EamonnJ.Keogh	4
KeisukeIshibashi	HitoakiSakamoto	1
YumaoLu	XinLi	1
Antti-PekkaLiedes	AntoniWolski	1
SubramanyamChitti	LingLiu	1
MohandBoughanem	KarenSauvagnat	1
JoydeepGhosh	GunjanGupta	2
ChuanjunLi	B.Prabhakaran	1
Jos*IgnacioMart*n	IbaiGurrutxaga	1
WenkeLee	GuofeiGu	1
Shinn-JangHo	Kuan-WeiChen	1
LouiqaRaschid	FelixNaumann	1
TamaraA.Schwimmer	SayaV.Nagori	1
RebeccaCasta*o	DominicMazzoni	1
GerhardWeikum	FabianM.Suchanek	1
ShubhaU.Nabar	AndrewTomkins	1
S.Muralidhar	AnilNori	1
ValentinKuznetsov	MirekRiedewald	1
OlivierVerscheure	DeepakS.Turaga	1
SiuManLui	Kok-LeongOng	1
WeiyiMeng	A.PrasadSistla	1
StefanConrad	CristianP*rezdeLaborda	1
SioIongAo	PakChungSham	1
DominicMazzoni	AshleyDavies	1
DimitrisK.Tasoulis	DavidJ.Hand	1
DiveshSrivastava	BengChinOoi	1
Ming-SyanChen	Chih-MingHsu	1
ValentinKuznetsov	AndersRyd	1
RalfSchenkel	MartinTheobald	2
PaulThomas	DavidHawking	1
WyattT.Clark	PredragRadivojac	1
YongHongTian	TiejunHuang	1
LathaS.Colby	HetalThakkar	1
Zolt*nGy*ngyi	JanO.Pedersen	1
StefanB*ttcher	JinghuaGroppe	1
VasantHonavar	SamikBasu	1
JianjunXu	JiahengLu	1
EmilioSoler	EduardoFern*ndez-Medina	1
JoostN.Kok	JeroenS.deBruin	1
Suh-YinLee	Chin-ChuanHo	2
HuiruZheng	AlbanChesneau	1
PatrickBaldasare	LianYan	1
TillWestmann	NicolaOnose	1
LeonardJ.Seligman	ArnonRosenthal	2
RichardMortier	AntonyI.T.Rowstron	2
OliverG*nther	MatthiasFischmann	1
PramodSingh	ArielSepulveda	1
YehoshuaSagiv	YaronKanza	1
SergeAbiteboul	KarlSchnaitter	1
ZaiqingNie	MingjieZhu	1
HongxingHe	ChrisKelman	2
MaguelonneTeisseire	Fran*oisTrousset	1
SpiridonBakiras	KyriakosMouratidis	1
ZhenXu	BinhengSong	1
MatthijsvanLeeuwen	JillesVreeken	2
YokoNishihara	WataruSunayama	1
HuiXiong	EnhongChen	1
XiaomingLi	WeijiaJia	1
YunyueZhu	RuiWang0002	1
RameshJain	AmarnathGupta	1
EdwardY.Chang	ChristopherJ.Hughes	1
S.Sudarshan	RavishankarRamamurthy	1
TobiasRiemenschneider	J*rgenKr*mer	1
SungHoHa	Sang-ChanPark	1
NitinAgarwal	JianpingZhang	1
VietPhuongNguyen	TakashiWashio	1
JeffreyF.Naughton	AmeetKini	1
JuanM.Vara	EsperanzaMarcos	1
ThomasSchwentick	KarlTuyls	1
Chung-WenCho	ArbeeL.P.Chen	1
ZhenjieZhang	BingTianDai	1
XiaofeiXu	JoshuaZhexueHuang	2
KyoungSooBok	JaeSooYoo	1
MuraliMani	LingWang	3
PalomaD*az	IgnacioAedo	1
WilliamM.Pottenger	SudhanKanitkar	1
JunLi	HaofengZhou	1
YuelongJiang	KeWang	1
VincenzoMoscato	AntonioPicariello	1
NingYu	KienA.Hua	2
TovaMilo	KarlSchnaitter	1
KarlTuyls	FrankNeven	1
DeborahS.Gross	AnnaM.Ritz	1
YitzhakMandelbaum	RobertGruber	1
Seung-wonHwang	ChristianA.Lang	1
ZhenZhang	MinWang	1
SujeetBanerjee	AnilMalkani	1
PanayiotisTsaparas	HeikkiMannila	1
ZhaohuiWu	HengWang	1
JeffCerwinske	FabioA.Gonz*lez	1
SujeethThirumalai	KangLi	1
GregoryJ.Sharp	ChristopherD.Jones	1
SanjayChawla	FlorianVerhein	2
TakashiWashio	PhuChienNguyen	1
ManoliAlbert	CarlosCetina	1
SurajitChaudhuri	NicolasBruno	2
EllaBingham	AristidesGionis	1
MichaelGruber	MatthiasSchubert	1
Ren*eJ.Miller	ArielFuxman	2
MarcusFontoura	AndrewTomkins	1
SelcukAya	DanielRiley	1
XiaoMingZhou	TatKeongLoh	1
Yu-TingKung	Jia-LingKoh	1
XinYao	HuanhuanChen	1
XiaohuiYu	SudiptoGuha	1
SylvieGuillaume	LeilaNemmicheAlachaher	1
JianPei	DongwonLee	1
VagelisHristidis	S.Sudarshan	1
VolkerMarkl	HolgerKache	2
Hyeon-JoongYoo	ByounghoSong	1
XiaolingWang	WilfredNg	1
YossiMatias	NatashaDrukh	1
YukioOhsawa	YoshiharuMaeno	2
VictorVianu	LiyingSui	1
RobertoCelle	MarcoMesiti	1
JianChihOu	Jen-WeiHuang	1
WeiminXiao	JeffreyBenkler	2
JianHuang0002	DingZhou	1
Chia-HanLin	ArbeeL.P.Chen	1
YingYan	FengYu	1
RuomingJin	LeonidGlimcher	1
PierpaoloVittorini	FerdinandodiOrio	1
RinaPanigrahy	AndreiZ.Broder	1
WenkeLee	RobertoPerdisci	1
ElkeA.Rundensteiner	AparnaS.Varde	1
Tyng-RueyChuang	Chia-HsinHuang	1
DannySoetanto	AliAsheibi	1
GeorgePallis	AntonisSidiropoulos	1
YutakaHirokawa	KimihiroYamamoto	1
XinChen	ChengcuiZhang	2
WeihongWang	FilliaMakedon	1
LiseGetoor	ChristopherP.Diehl	1
NoriakiKuwahara	KiyoshiKogure	1
SouptikDatta	HillolKargupta	1
IndranilBose	ChenXi	1
MeteCelik	JamesA.Shine	1
TianyiJiang	AlexanderTuzhilin	1
JingGao	JerryScripps	1
K.SjoerdMullender	JanFlokstra	1
EricLo	DonaldKossmann	1
Rapha*lSquelbut	OlivierCur*	1
ZhaohuiWu	HuajunChen	2
TheoH*rder	KonstantinLuttenberger	1
OmarBoucelma	Fran*ois-MarieColonna	1
Kuan-WeiChen	Hung-MingChen	1
Jos*Mar*aMart*nez-Otzeta	AitzolAstigarraga	1
TheoniPitoura	NikosNtarmos	1
SomchaiChatvichienchai	LeGruenwald	1
QuangHieuVu	AoyingZhou	1
ShaxunChen	JianLu	1
YogeshSimmhan	BethPlale	1
StijnHeymans	MustafaJarrar	1
LeeBelbin	BenRaymond	1
TovaMilo	SergeAbiteboul	1
ChristophKiefer	AbrahamBernstein	2
LinglingZhang	GuangliNie	1
YunhaoLiu	WenweiXue	1
MarcosR.Vieira	ChristosFaloutsos	1
ShubhaU.Nabar	AndreiZ.Broder	1
XuweiLiang	JingHua	1
NoamPalatin	ArieLeizarowitz	1
YaboXu	JianPei	1
RajeevMotwani	KrishnaramKenthapadi	1
RaghavKaushik	NileshN.Dalvi	1
JiefengCheng	HaixunWang	1
IsaacG.Councill	C.LeeGiles	1
YingLi	BenyuZhang	2
MartinEster	J*rgSander	1
GeorgeH.L.Fletcher	CatharineM.Wyss	1
LizhengJiang	DehuiZhang	1
ShawnR.Jeffery	JenniferWidom	1
TiffanyDohzen	Seok-WonSeong	1
XiangyangLan	JonM.Kleinberg	1
MichailVlachos	ArisAnagnostopoulos	2
MohamedA.Sharaf	KirkPruhs	1
GregoryBuehrer	AmolGhoting	1
RoyGr*nmo	M.Glittum	1
Ois*nBoydell	BarrySmyth	1
PavelBerkhin	HectorGarcia-Molina	1
NealFeierabend	AuroopR.Ganguly	1
SrinivasanParthasarathy	DuyguUcar	1
MichaelR.Berthold	GiuseppeDiFatta	1
HuaLi	BenyuZhang	1
RakeshAgrawal	ChristopherM.Johnson	1
TatsuyaMori	HitoakiSakamoto	1
KotagiriRamamohanarao	HongjianFan	1
HariBalakrishnan	AllenMiu	1
YoonhoPark	LisaAmini	1
YannisManolopoulos	DimitriosKatsaros	1
RobertJ*schke	ChristophSchmitz	1
NiallM.Adams	DimitrisK.Tasoulis	1
AngelaC.Sodan	A.Burrell	1
SebastianMichel	GerhardWeikum	4
RaviKumar	DeepayanChakrabarti	1
YaronKanza	ItzhakFadida	1
HuimingQu	DanielMoss*	1
MatthiasSchubert	ElkeAchtert	1
LenaStr*mb*ck	DavidHall	1
KeiShiuHo	EdwardK.F.Dang	1
ValeriaDeAntonellis	DevisBianchini	1
GautamDas	AmitAnilNanavati	1
ChengXiangZhai	BinTan	1
Seok-WonSeong	MichaelStonebraker	1
YanJia	ShuqiangYang	1
ZhenjieZhang	H.V.Jagadish	3
RongZhang	H.V.Jagadish	2
ToddEavis	E.Sithirasenan	1
Shi-HuaZhang	Hong-WeiLiu	1
RalphSchlapbach	AttilaGyenesei	1
DiveshSrivastava	AmitMarathe	1
ShanWang	JeffreyXuYu	1
YinYang	BernhardSeeger	1
SvetlanaVinnik	FlorianMansmann	1
SusanB.Davidson	HaejoongLee	1
RaghuRamakrishnan	PetrosManiatis	1
YaZhang	ChrisH.Q.Ding	1
LiqiangGeng	HowardJ.Hamilton	1
JinyanLi	GuimeiLiu	2
LawrenceB.Holder	JacekP.Kukluk	1
CosimoPalmisano	AlexanderTuzhilin	1
LichengJiao	JunZhao	1
HeliHiisil*	EvimariaTerzi	1
SouravS.Bhowmick	ErwinLeonardi	1
PrasanRoy	MichaelReichert	1
KonstantinosStamos	AthenaVakali	1
ZengLian	JiaweiHan	1
JulioC.L*pez	GerdHeber	1
WalidG.Aref	RamyEltarras	1
Sei-HyungLee	KarenM.Daniels	1
DavidE.Gay	BoonThauLoo	1
ThomasG.Smith	AnnaM.Ritz	1
ThomasSchwentick	GeertJanBex	1
PhilippeCudr*-Mauroux	KarlAberer	1
SunS.Chung	Gultekin*zsoyoglu	1
MahadevanSubramanian	CalistoZuzarte	1
MarcusFontoura	AndreiZ.Broder	2
FlavianVasile	Dae-KiKang	1
AsumanDogac	AlperOkcan	1
HaixunWang	GabrielPuiCheongFung	1
BernhardSeeger	AkriviVlachou	1
SaileshKrishnamurthy	ChungWu	1
S.S*nchez	PilarParra	1
NikosMamoulis	DavidW.Cheung	2
MartaMattoso	AlexandreAndrade	1
RobertGruber	MaryF.Fern*ndez	1
WesleyM.Hochachka	MohamedFaridElhawary	1
MasaruKitsuregawa	HiroshiOno	1
DanielRiley	AndersRyd	1
WangChiewTan	LauraChiticariu	2
ShivnathBabu	PiyushShivam	1
GeorgeKarypis	AlMamunurRashid	1
XiaoleiLi	HectorGonzalez	3
JianliangXu	GailMitchell	1
RajshekharSunderraman	PaulS.Katz	1
MauricevanKeulen	JanRittinger	2
HyunWoongShin	EduardH.Hovy	1
Jia-YuPan	ChristosFaloutsos	3
NicolaeConstantinescu	GeorgeStephanides	1
ManjaNelius	IlvioBruder	1
QiankunZhao	LeGruenwald	1
Xian-ShengHua	Li-RongDai	1
NickKoudas	DimitrisTsirogiannis	1
StephenWright	AhmedAyad	1
XiaoboZhou	TuanD.Pham	1
YingxinLi	GaoCong	1
ShoushenYang	HongSu	1
RosieJones	BingLiu0003	1
PascualQueralt	LuisHoyos	1
KhanhVu	DanzhouLiu	1
ShubhaU.Nabar	RajeevMotwani	2
YanqingZhang	XiaohuaHu	1
Tyng-RueyChuang	JamesJ.Lu	1
LidanShou	ChunChen	1
OlegRostanin	AndreasDengel	1
SergeyMelnik	JohnE.Churchill	1
KeWang	JianPei	1
SudhanKanitkar	MuratCanGaniz	1
RaymondJ.Mooney	BeenaKamath	1
YunChi	Jun'ichiTatemura	1
JohnRiedl	AlMamunurRashid	1
RyoichiKawahara	AtsushiKobayashi	1
RainerSchmidt	BodoVogt	1
InderjitS.Dhillon	DharmendraS.Modha	1
JunZhu	BoZhang	1
SoujanyaVadapalli	LaurentMignet	1
LathaS.Colby	JunRao	1
JoelKorb	ArnonRosenthal	1
Josep-LluisLarriba-Pey	JosepAguilar-Saborit	1
Mar*aJ.Escalona	ManuelMej*as	1
NitinAgarwal	HuanLiu	1
NarenRamakrishnan	K.P.Unnikrishnan	1
RamayyaKrishnan	GeorgeT.Duncan	1
Wen-SyanLi	CalistoZuzarte	1
YongHu	JuhuaChen	1
MarelisCardenas	LouiqaRaschid	1
XueyanTang	MinjiWu	1
ZonghongZhang	BinCui	1
NicolaeConstantinescu	MihaiGabroveanu	1
Ming-SyanChen	JianChihOu	1
Jes*sM.P*rez	JavierMuguerza	1
Zhongfei(Mark)Zhang	XiaoyunWu	1
StavrosHarizopoulos	DanielJ.Abadi	1
SvenHelmer	MatthiasBrantner	1
WilliamY.Arms	LawrenceGibbons	1
OscarValdivia	MichailVlachos	1
RonaldPadur	DirkRother	1
R.MarkGreenwood	BinlingJin	1
SteveA.Chien	RebeccaCasta*o	1
XiangyangLan	DanielP.Huttenlocher	1
LizhuZhou	GeorgeKarypis	1
WenfeiFan	GaoCong	2
Pang-NingTan	JerryScripps	2
BoYang	AliR.Hurson	1
JigneshM.Patel	JamesS.Friedman	1
ToddC.Mowry	AnastassiaAilamaki	1
NadirWeibel	BeatSigner	1
JoshuaZhexueHuang	GrahamJ.Williams	1
PatrickHaffner	ChrisVolinsky	1
YihongDing	DavidW.Embley	1
PierreGan*arski	AnnettWania	1
J.WennyRahayu	DavidTaniar	1
WeiliWu	HuiXiong	1
SihemAmer-Yahia	JayavelShanmugasundaram	1
SungJinKim	ShinYoungKwon	1
RaymondChi-WingWong	JiuyongLi	1
IsaacG.Councill	DingZhou	1
MarkDaly	KathleenFisher	1
VictorC.S.Lee	HaiboHu	1
StephanSchosser	RainerSchmidt	1
MarkusHagenbuchner	AhChungTsoi	1
IlvioBruder	AndreasHeuer	1
MichaelJ.Taylor	ChrisBurges	1
LiutongXu	BinWu	1
ShicongMeng	CongShi	1
RamezElmasri	KyungseoPark	1
YinYang	J*rgenKr*mer	1
YokoNishihara	MasahikoYachida	1
YoonhoPark	RichardKing	1
TiankaiTu	GerdHeber	1
RayidGhani	AndrewE.Fano	1
MarcFriedenberg	DhirajJoshi	1
PhilipS.Yu	EamonnJ.Keogh	1
OuriWolfson	HuabeiYin	1
YongShi	JunLi	1
HyunjinYoon	CyrusShahabi	1
KatjaHose	AndreasJob	1
JinHuang	CharlesX.Ling	1
Yen-YuChen	AlexanderMarkowetz	1
JiuyongLi	DamienMcAullay	1
RobertWingPongLuk	Kam-FaiWong	1
AgmaJ.M.Traina	AdrianoS.Arantes	1
WilliamJ.Merline	DennisDeCoste	1
YijunLi	QiangYe	1
VishalSikka	RajeevRastogi	1
SamuelMadden	DanielJ.Abadi	2
Tie-YanLiu	HangLi	1
ElisaBertino	AlbertoTrombetta	1
LucasScharenbroich	DennisDeCoste	1
JacekP.Kukluk	DianeJ.Cook	1
WenshengYi	BinShen	1
TaoTao	ChengXiangZhai	1
RyoichiKawahara	HitoakiSakamoto	1
NickKoudas	GautamDas	1
TakeshiYamada	KazumiSaito	2
RaghuKrishnapuram	GaneshRamakrishnan	1
SiegfriedNijssen	LucDeRaedt	1
J*rgenKr*mer	BernhardSeeger	3
ShuigengZhou	GrahamJ.Williams	1
VladislavShkapenyuk	StavrosHarizopoulos	1
Ken'ichiIshikawa	AtsuyukiMorishima	1
LuisOt*vioAlvares	BartKuijpers	1
VasilisVassalos	V*clavL*n	1
SebastianMichel	JosianeXavierParreira	1
SlawomirStaworko	JerzyMarcinkowski	1
MelanieOsl	ClaudiaPlant	1
LiseGetoor	GalileoNamata	1
NiteshV.Chawla	AmitabhChaudhary	1
ShengZhang	JamesFord	3
RaghuRamakrishnan	AnHaiDoan	1
RonenFeldman	GregoryPiatetsky-Shapiro	2
XiaofeiXu	ShengchunDeng	1
VeliBicer	AlperOkcan	1
RameshJain	AlbertoDelBimbo	1
KazuyoNarita	HiroyukiKitagawa	1
JiaweiHan	HongCheng	4
ScottSirowy	JinShieh	1
KangRyoungPark	ByounghoSong	1
M.NarasimhaMurty	J.SakethaNath	1
OlfaNasraoui	JaideepSrivastava	1
YuelongJiang	WenJin	1
MarcoZaffalon	KeithWesnes	1
Wang-PinHsiung	Hua-GangLi	2
SivaGurumurthy	KoustuvDasgupta	1
YiZhuang	QingLi	1
JulienEtienne	BerndWachmann	1
VenkatesanT.Chakaravarthy	MukeshK.Mohania	1
WenxueHuang	MiloradKrneta	1
TorstenSteinbach	ManishBhide	1
Johann-AdolfM*ller	EmilioBenfenati	1
YiChen	HaejoongLee	1
SimonLaws	JimMelton	1
JonHutchins	AlexanderT.Ihler	1
SenthilPeriaswamy	R.BharatRao	1
LobnaHlaoua	KarenSauvagnat	1
SamirKhuller	FelixNaumann	1
TovaMilo	SimonKamenkovich	1
JinPei	DavidA.Bell	1
TaufikAbidin	HonglinLi	1
YuchunTang	RajshekharSunderraman	1
SudeeptBhatnagar	SongWang	1
SergeiEvdokimov	MatthiasFischmann	1
Yiu-KaiNg	BinWang	1
KevinChen	BretHull	1
StefanKrompass	DanielGmach	1
Zhongfei(Mark)Zhang	PhilipS.Yu	1
MichaelD.Gordon	JiZhu	1
JosephM.Hellerstein	DavidE.Gay	1
StavrosHarizopoulos	IppokratisPandis	1
ChristophHeinz	BernhardSeeger	2
BouchraBouqata	AdamMarcus0002	1
JudeW.Shavlik	Bee-ChungChen	1
MichailVlachos	DeepakS.Turaga	1
JianyongWang	GuoliangLi	1
XiaoyuanWang	JianXu	2
StevenP.Callahan	JulianaFreire	2
JianYin	JeffreyXuYu	1
DavidMaier	BillHowe	1
GeorgiaKoutrika	AlkisSimitsis	2
SteveA.Chien	BenjaminCichy	1
RajeevRastogi	C.Mohan	1
SigalSahar	KalyanBeemanapalli	1
TorstenSteinbach	D.V.S.Ravikant	1
ChristosFaloutsos	AgmaJ.M.Traina	3
XinXu	WeiWang0010	1
RogerZimmermann	HaojunWang	1
YutakaHirokawa	RyoichiKawahara	1
MarcelvanRooyen	InnaKolyshkina	1
RobertGrossman	MohammedJaveedZaki	2
NadavEiron	AndreiZ.Broder	1
MemaRoussopoulos	JonathanLedlie	1
TaroTezuka	HiroshiKori	1
EricLo	CarstenBinnig	1
YuefengLi	RichiNayak	1
NabilBenayadi	MarcLeGoc	1
SamratGanguly	ElkeA.Rundensteiner	1
NickCraswell	MichaelJ.Taylor	1
JunfengWu	AndrewFoss	1
RudiBelotti	MoiraC.Norrie	1
TobiasRiemenschneider	MichaelCammert	1
JureLeskovec	JonM.Kleinberg	1
VincentC.S.Lee	RossGayler	1
VivekSawant	JasleenKaur	1
JieZhou	ChunyuYang	2
ZhaohuiWu	YuxinMao	1
SelcukAya	ManuelCalimlim	1
Mar*aCruzValiente	M*nicaMarrero	1
Ya-WenHsu	NaureenMoon	1
YannisManolopoulos	GeorgePallis	1
JianPei	BoZhang0002	1
XinLi	BingLiu	1
Yuan-ChiChang	Seung-wonHwang	1
MaheshShrestha	HowardJ.Hamilton	1
TomArmstrong	TimOates	1
SimeonJ.Simoff	DebbieZhang	2
MihaiLupu	BeiYu	1
SreeramBalakrishnan	RaghuKrishnapuram	1
JianpingZhang	HuanLiu	2
SuryaNepal	JohnJ.Zic	1
PilarParra	O.Garc*a	1
ZhenbangRong	KangXie	1
VivekNigam	AlexanderKozlenkov	1
PranayJain	LuisGravano	1
StephenChi-faiChan	DikLunLee	1
MichaelSchroeder	GihanDawelbait	1
MatthiasSchubert	AlexeyPryakhin	4
PeriklisAndritsos	ArielFuxman	1
SamuelMadden	HariBalakrishnan	1
JulianaFreire	Jo*oM.B.Cavalcanti	1
PavelBerkhin	JanO.Pedersen	1
PeterA.Boncz	MarcinZukowski	1
MartinAtzm*ller	FrankPuppe	1
Tak-LamWong	Shing-KitChan	2
UnilYun	JohnJ.Leggett	1
OsmarR.Za*ane	Maria-LuizaAntonie	1
ChristosFaloutsos	ChristianB*hm	1
ZhihaiWang	LingzhiLiao	1
IonStoica	DavidE.Gay	1
Kian-LeeTan	BinCui	1
VanjaJosifovski	MarcusFontoura	1
PeiyaLiu	FredAzar	1
SaikatMukherjee	ChangZhao	1
Pu-JenCheng	Ching-HsiangTsai	1
YiChen	TeLi	1
YipingKe	WilfredNg	4
ShiweiTang	DehuiZhang	1
RiadhBenMessaoud	OmarBoussaid	1
SunilPrabhakar	SarvjeetSingh	1
WeijunZhong	JunZhang	1
VikramGoyal	ShyamK.Gupta	1
JiuyongLi	HongxingHe	1
MichaelGibas	GuadalupeCanahuate	1
Ching-YungLin	BelleL.Tseng	1
GustavoAlonso	ChristianPlattner	1
NeoklisPolyzotis	KarlSchnaitter	1
ZhengChen	QiangYang	6
SriramKrishnan	R.BharatRao	1
RaffaelePerego	ClaudioLucchese	2
MatteoAlbertoSorrenti	MarcoMesiti	1
RajP.Gopalan	N.R.Achuthan	1
NickKoudas	AnthonyK.H.Tung	2
VibhutiS.Sengar	JayantaBasak	1
NanDu	BinWu	1
JunRao	HamidPirahesh	1
TieWang	JiepingYe	1
Wei-YingMa	LeiZhang0001	1
YangSong	DingZhou	1
YehudaKoren	StephenC.North	1
OrlandoAvila-Garc*a	E.VictorS*nchezRebull	1
AthenaVakali	AntonisSidiropoulos	1
RuiZhou	ChuanXiao	1
FlavianVasile	AdrianSilvescu	1
JohannesGehrke	FanYang0002	2
StefanBrecheisen	Hans-PeterKriegel	3
MarcoSaerens	AlainPirotte	1
KevinSmathers	KannanGovindarajan	1
TakahiraYamaguchi	MihoOhsaki	3
SteliosPaparizos	H.V.Jagadish	1
SatoshiOyama	KeishiTajima	2
RohitKumar	KrishnaKumaraswamy	1
TaichiMuraki	RyutaroIchise	1
RayidGhani	MarkoKrema	1
ShusakuTsumoto	KimikoMatsuoka	1
FrankLemke	EmilioBenfenati	1
JunYuan	AliBahrami	1
ZhenjieZhang	ShuqiaoGuo	1
RamayyaKrishnan	JamieCallan	1
DavidJ.DeWitt	AmeetKini	1
YanWang	PingLing	1
NaokiAbe	BiancaZadrozny	1
VishalS.Batra	InderpalNarang	1
RussellGreiner	DaleSchuurmans	1
WangChiewTan	BogdanAlexe	1
LucioGoglia	LucaDeRosa	1
ThomasDoggett	RonaldGreeley	1
RobertW.P.Luk	DikLunLee	1
JonathanC.Yang	HyoilHan	1
P.Anandan	MeichunHsu	1
ToralfKirsten	J*rgLange	1
YassineLassoued	BarbaraCatania	1
JeffM.Phillips	DeepakAgarwal	1
SzymonJaroszewicz	BartGoethals	1
NarenRamakrishnan	LizhuangZhao	1
EykeH*llermeier	AndreasN*rnberger	1
MarcelKaram	JihadBoulos	1
Wei-YingMa	JunZhu	1
SunilPrabhakar	JeffreyScottVitter	1
OmarBoucelma	AbdelkaderB*tari	1
SiegfriedNijssen	AlbrechtZimmermann	1
JayavelShanmugasundaram	FengShao	1
JennieL.C.Lam	BoFeng	1
NadavEiron	MichaelHerscovici	1
JiuyongLi	FatenKhalil	1
WangKayNgai	KevinY.Yip	1
FarookhKhadeerHussain	ElizabethChang	1
YuefengLi	Sheng-TangWu	1
ChangzhouWang	AliBahrami	1
RobertoTrasarti	ClaudioLucchese	1
JunYan	BenyuZhang	4
WaiLam	Shing-KitChan	2
KenSamuel	ArnonRosenthal	1
Zhi-HuaZhou	JianxinWu	1
SeokJinIm	KwangJinPark	1
AndrewTomkins	AndreiZ.Broder	1
YimingMa	DawitYimamSeid	1
ZhipingZeng	JianyongWang	2
IonStoica	BoonThauLoo	1
ReynoldCheng	BenKao	2
TonyFallon	JiuyongLi	1
NanTang	HaifengJiang	1
YangZhang	EugeneShih	1
ThomasKabisch	DirkRother	1
Yen-YuChen	TorstenSuel	1
Seo-YoungKim	Jae-GilLee	1
LimsoonWong	JinyanLi	1
PauloJ.Azevedo	FernandoPereira0002	1
AndreasHeuer	AmmarBalouch	1
VicentePelechano	ManoliAlbert	1
MemaRoussopoulos	MargoI.Seltzer	1
AzizGulbeden	AmrElAbbadi	1
YiZhang0010	XiaomingJin	1
ZhihuiWang	BaileShi	1
ChristianS.Jensen	BengChinOoi	2
ZaiqingNie	Wei-YingMa	2
WeiyiMeng	AbdurChowdhury	1
Young-RaeCho	AidongZhang	1
PhilipS.Yu	BaileShi	1
HungKookPark	DaeWoongRhee	1
PhilippeThiran	Jean-RochMeurisse	1
TarekHamrouni	SadokBenYahia	1
JiefengCheng	JeffreyXuYu	2
MelanieHilario	AlexandrosKalousis	2
TakahikoIto	DaichiMochihashi	2
VibhutiS.Sengar	SoujanyaVadapalli	1
KarlAberer	ChristianLovis	1
NagwaM.El-Makky	KhalilM.Ahmed	1
MichaelH.B*hlen	JohannGamper	2
XiangjiHuang	AijunAn	2
JimCordes	ChristopherD.Jones	1
OlivierVerscheure	ArisAnagnostopoulos	1
JaganSankaranarayanan	HananSamet	1
RaviJanardan	ChandraKambhamettu	1
HenryTan	AmandeepS.Sidhu	1
VincentS.Tseng	Tzung-PeiHong	1
SangeetaDoraiswamy	JunRao	1
ZaiqingNie	FeiXing	1
FrancescoBonchi	ClaudioLucchese	1
XuanZheng	KathleenFisher	1
ThomasHeinis	SimelaTopouzidou	1
DingZhou	BingjunSun	1
YannisManolopoulos	PanagiotisSymeonidis	1
Ming-SyanChen	Hao-PingHung	1
GautamDas	AnupamJoshi	1
ThomasHeinis	M.Glittum	1
PatrickValduriez	MartaMattoso	1
MauricevanKeulen	K.SjoerdMullender	1
WuWeimin	PengQingsong	1
JonM.Kleinberg	DanielP.Huttenlocher	1
Zhi-QiangLiu	YiWang	1
LiminLin	JianhongWu	1
PingLin	K.Sel*ukCandan	1
WeiLi	MinghongZhou	1
SongWang	HongSu	1
TanApaydin	HakanFerhatosmanoglu	1
VinodYegneswaran	LeiChen0003	1
YingjieTian	KunZhao	1
RafiAhmed	AndrewWitkowski	1
RebeccaBraynard	JunYang0001	3
JohannesGehrke	DanielKifer	2
RobPike	JayantMadhavan	1
IsaacG.Councill	HongyuanZha	1
K.SjoerdMullender	JensTeubner	1
ZhipingZeng	LizhuZhou	2
YanleiDiao	EugeneWu0002	1
ChrisHayworth	AnishDasSarma	1
KrunalPatel	KajalT.Claypool	1
RobertJ*schke	AndreasHotho	1
PeterMork	LeonardJ.Seligman	1
GerhardWeikum	ChristianZimmer	1
PeterK.Campbell	BhavaniRaskutti	1
SihemAmer-Yahia	MouniaLalmas	1
YongluanZhou	BengChinOoi	1
DanielKeren	AssafSchuster	1
QiangQiu	FelixNaumann	1
KiyoharuAizawa	GamhewageC.deSilva	1
YaboXu	AdaWai-CheeFu	1
YuanzhenWang	HuiXiong	1
RaviKumar	MarcusFontoura	1
TamaraA.Schwimmer	LawrenceH.Reeve	1
SubhasriDuttagupta	AnilBahuman	1
TongSun	LiWei	1
ZhihuiWang	WeiWang0009	1
Shinn-YingHo	Chih-HungHsieh	1
ShijiSong	GuoyangShen	1
NavenduJain	LisaAmini	1
Wei-YingMa	FeiWu	1
LingzhiLiao	LianweiZhao	1
Shyan-MingYuan	Jie-TsungLi	1
PhilipS.Yu	DeepakS.Turaga	1
RohanA.Baxter	LifangGu	1
FangLiu	ClementT.Yu	1
TomohiroYoshihara	TakashiKobayashi	1
SabahCurrim	CurtisE.Dyreson	1
YanLiu0002	MarkoKrema	1
YingZhang	XueminLin	1
JunYang0001	CarlaSchlatterEllis	1
YiWang	JianhuaFeng	1
StefanSiersdorfer	RalitsaAngelova	1
PaulJ.Fortier	DajunWang	1
RiteshKumar	NagaK.Govindaraju	1
LucioGoglia	AntonioAlbano	1
SpirosPapadimitriou	ChristosFaloutsos	1
YixinDiao	SamLightstone	1
ZaiqingNie	ShumingShi	1
PakChungSham	MichaelK.Ng	1
PeixiangZhao	JeffreyXuYu	1
XingsenLi	AihuaLi	1
RuiZhang0003	BengChinOoi	2
WynneHsu	GaoCong	1
Wei-ShinnKu	HaojunWang	1
GeorgeKarypis	AdamLaPitz	1
JayendraVenkateswaran	ChristopherM.Jermaine	1
XiaohuaZhou	XiaohuaHu	3
RobertJ.Calin-Jageman	HaoTian	1
ShenHuang	Jian-TaoSun	1
VenkatesanT.Chakaravarthy	PrasanRoy	1
KaraneVieira	Jo*oM.B.Cavalcanti	1
ZhenHuaLiu	AnguelNovoselsky	1
StratosIdreos	ChristosTryfonopoulos	1
PeiSun	BavaniArunasalam	1
YuetingZhuang	LeiChen0002	1
PingWu	HuanLiu	1
RajeevRastogi	P.Anandan	1
MarianoP.Consens	BillO'Farrell	1
DavidMaier	AlonY.Halevy	1
ZhengChen	YingLi	2
SongtingChen	Jun'ichiTatemura	3
ZhongfeiZhang	FlorentMasseglia	1
RichardKing	HenriqueAndrade	1
Chien-YuChen	Baw-JhiuneLiu	1
KaraneVieira	EdlenoSilvadeMoura	1
Sheau-DongLang	KhanhVu	1
KenC.K.Lee	JulianWinter	2
ObiL.Griffith	MartinEster	1
YanshengLu	RongHu	1
RonnieBathoorn	ArnoSiebes	1
SimeonWarner	JohannesGehrke	1
SangsooSung	DennisMcLeod	1
ThierryCruanes	HongSu	1
YixinDiao	MaheswaranSurendra	1
JianPei	CharuC.Aggarwal	1
O.Rodr*guez	DanielMeziat	1
PeterA.Boncz	MauricevanKeulen	2
HaggaiRoitman	AvigdorGal	1
QiLi	JinboBi	1
NathanSeeley	GianlucaTonti	1
YehoshuaSagiv	SaraCohen	1
NivioZiviani	*lvaroR.PereiraJr.	1
MirekRiedewald	L.PaulChew	1
SourashisRoy	MichaelReichert	1
SvenPuhlmann	MelanieWeis	1
RamasamyUthurusamy	P.S.Sastry	1
TharamS.Dillon	RajuganRajagopalapillai	1
ZhaohuiWu	MinYao	1
I-JenChiang	FurenXiao	1
YoshiteruNakamori	TuBaoHo	1
HeikkiMannila	EvimariaTerzi	1
Xian-ShengHua	MengWang	1
HongyuanZha	C.LeeGiles	2
GrahamJ.Williams	DamienMcAullay	1
WeiWang	JunLi	1
YingyiBu	ShaxunChen	1
BrigitteMathiak	AndreasKupfer	1
O.Garc*a	F.Alcojor	1
YuniXia	SarvjeetSingh	1
Hj*rdisHoff	AphroditeTsalgatidou	1
SimeonJ.Simoff	JohnK.Debenham	1
YaZhang	TaoLi	1
RogerMingHiengTing	JamesBailey	1
VivekNigam	GihanDawelbait	1
GustavoAlonso	DonaldKossmann	1
ZhengShao	HongyanLiu	3
WeiWang0010	JiaweiHan	1
UtkarshSrivastava	TamMinhTran	1
DingyiHan	CongShi	1
YongShi	YiPeng	3
StavrosHarizopoulos	SamuelMadden	1
ThomasG.Smith	LeahE.Steinberg	1
King-LupLiu	ClementT.Yu	1
ToshihiroKamishima	ShotaroAkaho	2
ZhengChen	JilinChen	1
JiaweiHan	ChenChen	3
ShanWang	AnthonyK.H.Tung	1
GerhardWeikum	DeboraDonato	1
NivioZiviani	BerthierA.Ribeiro-Neto	1
JianPei	ErginElmacioglu	1
PabitraMitra	KamalTiwari	1
YanJia	BoDeng	1
JohnMylopoulos	IlujuKiringa	1
NevinM.Darwish	NadiaHegazy	1
VinodYegneswaran	RaghuRamakrishnan	2
SivaRavada	NicoleAlexander	1
HuidongJin	ChrisKelman	2
Ming-SyanChen	Mi-YenYeh	1
RongGe	BoazBen-Moshe	1
NicholasGerner	JohannesGehrke	1
ToreRisch	ErikZeitler	1
CatrielBeeri	AnatEyal	1
NamNguyen	MohamedFaridElhawary	1
YunyueZhu	DavidB.Lomet	1
MichaelH.B*hlen	ChristianS.Jensen	1
LouiqaRaschid	AmarnathGupta	1
KatjaHose	Kai-UweSattler	2
Jun'ichiTatemura	Hua-GangLi	2
TimosK.Sellis	PanosVassiliadis	1
JunYang0001	HaiYu	1
SarunasGirdzijauskas	ChristianLovis	1
StephenB.Pope	JohannesGehrke	1
LeanderSchietgat	JanStruyf	1
MoonJeungJoe	Han-DeokLee	1
VictorMunt*s-Mulero	PedroTrancoso	1
SzymonJaroszewicz	DanA.Simovici	1
WilliamL.Barth	ShirleyCohen	1
WilsonC.Hsieh	JayantMadhavan	1
JingBai	Jian-YunNie	1
Wook-ShinHan	Kyu-YoungWhang	1
KimNguyen	DarioColazzo	1
PeerKr*ger	ArthurZimek	2
LipingJi	Kian-LeeTan	1
StevenP.Callahan	Cl*udioT.Silva	2
PavelDmitriev	LawrenceGibbons	1
JuliaDeneva	DavidA.Lifka	1
ManfredReichert	AndreasWombacher	1
XifengYan	FeidaZhu	1
VladimirBychkovsky	BretHull	1
KienA.Hua	DanzhouLiu	2
MaryannE.Martone	LiChen	1
MohammedK.Jaber	AndreiVoronkov	1
JuandeLara	FranciscoP*rez	1
YongYu	HangLi	1
MeteCelik	JamesP.Rogers	1
WenshengWu	WeiyiMeng	1
JinzeLiu	JanPrins	2
Wook-ShinHan	VijayshankarRaman	1
Woong-KeeLoh	Kyu-YoungWhang	2
IzchakSharfman	AssafSchuster	1
LeiChen0003	DavidR.Musicant	1
HongyuanZha	BingjunSun	1
NicoLavarini	BarbaraOliboni	1
RameshNatarajan	InderpalNarang	1
VictorS.Sheng	NazimH.Madhavji	1
T.S.Jayram	RaghuRamakrishnan	1
Kian-LeeTan	FengYu	1
RobLesslie	NianjunLiu	1
Tie-YanLiu	GuangFeng	2
VishalKapoor	MaguelonneTeisseire	1
KwanchaiEurviriyanukul	AlvaroA.A.Fernandes	1
WesleyM.Hochachka	MirekRiedewald	1
RobertWingPongLuk	K.L.Kwok	1
SongWang	ElkeA.Rundensteiner	3
NicuD.Cornea	DeborahSilver	1
JieChen	ChrisKelman	2
LeonardMcMillan	JinzeLiu	1
YangZhang	MichelGoraczko	1
YingZhu	HongYang	1
PauliMiettinen	HeikkiMannila	1
YanifAhmad	JohnJannotti	3
XiaojunChen	ShuigengZhou	1
ManjaNelius	AndreasHeuer	1
YanqingZhang	XiaodanZhang	1
SuryaNepal	FredericJaccard	1
JohnPearson	FredAzar	1
SamuelMadden	KevinChen	1
RonenFeldman	LiseGetoor	2
YangDu	TianXia	2
JeffreyF.Naughton	CristianEstan	1
Ren*eJ.Miller	C.T.HowardHo	1
RajshekharSunderraman	HongYang	1
MohammedJaveedZaki	AdrianoVeloso	1
Jos*Mar*aMart*nez-Otzeta	ElenaLazkano	1
NamyounChoi	HyoilHan	1
Xue-MeiNing	Shi-HuaZhang	1
WeiHong	DavidChu	1
MarcosSalganicoff	JianmingLiang	1
VladislavShkapenyuk	IppokratisPandis	1
XiaoyunWu	PhilipS.Yu	1
HariBalakrishnan	BretHull	1
SrinivasanParthasarathy	RuomingJin	1
MehmetErcanNergiz	ChrisClifton	1
MichaelPeterHaustein	ChristianMathis	1
WolfgangLehner	DirkHabich	1
MichaelC.Burl	LucasScharenbroich	1
PetrosManiatis	IonStoica	1
Miguel-*ngelSicilia	ElenaGarc*aBarriocanal	1
JiyingWang	FrederickH.Lochovsky	3
PaulOgilvie	MouniaLalmas	1
SoujanyaVadapalli	KamalakarKarlapalem	1
RitendraDatta	MarcFriedenberg	1
ShlomoGeva	CalumRobertson	1
YannisSismanis	PeterJ.Haas	1
OlatzArbelaitz	IbaiGurrutxaga	1
JiaweiHan	HectorGonzalez	3
YanguZhang	BinShen	1
VenkateshGanti	DongXin	1
SergioFlesca	FilippoFurfaro	1
ZhaohuiZheng	GordonSun	1
JuliaDeneva	DanielRiley	1
JulianWinter	JianliangXu	1
SrikantaJ.Bedathur	KlausBerberich	1
YasuhiroFujiwara	MasashiYamamuro	1
GeorgeAthanasopoulos	CesarePautasso	1
VagelisHristidis	PhilipS.Yu	1
WoohyunKim	DongmanLee	1
MarioPiattini	MacarioPolo	1
VagelisHristidis	RamakrishnaVaradarajan	1
YaboXu	KeWang	1
MingFan	MengxuLiu	1
BrianGabor	BettinaKemme	1
RudiBelotti	CorsinDecurtins	1
JohnJ.Zic	FredericJaccard	1
Yang-SaeMoon	Jin-HoKim	1
VassiaPavlaki	RadaChirkova	1
XiaolingWang	JuzhenHe	1
RichiNayak	EstherGe	1
XifengYan	JiaweiHan	4
SibelAdali	FrankS.Spear	1
ThierryCruanes	AndrewWitkowski	1
RiccardoRizzo	GiuseppeDiFatta	1
RaviJanardan	JiepingYe	2
ElisaBertino	ArjmandSamuel	1
FrankKlawonn	ClaudiaHundertmark	1
PetrosDrineas	MauroMaggioni	1
OlegRostanin	HaraldHolz	1
W.BruceCroft	KojiEguchi	1
PaulW.Purdom	NeleDexters	1
SuryaNepal	GregoireKraehenbuehl	1
WeiningQian	AnthonyK.H.Tung	1
XintaoWu	LingQiu	1
MartinEster	AoyingZhou	1
YunpengXu	ChangshuiZhang	1
FranzFaerber	DinaBitton	1
MicheleGorgoglione	AlexanderTuzhilin	1
FrankS.Spear	BoleslawK.Szymanski	1
MaryF.Fern*ndez	MarkDaly	1
SaharonRosset	ClaudiaPerlich	1
GautamDas	DipanjanChakraborty	1
ArsanySawires	AmrElAbbadi	1
RoelVercammen	JanHidders	1
RitendraDatta	JiaLi	1
RoyGeorge	BurcinBostan-Korpeoglu	1
YingxinLi	BinCui	1
ThierryCruanes	DineshDas	1
FabioAiolli	AlessandroSperduti	1
YanLiu0002	RayidGhani	1
JunchangJu	EricD.Kolaczyk	1
JamesP.Rogers	DanielBarbar*	1
J.SakethaNath	ChiranjibBhattacharyya	1
AshfaqA.Khokhar	AlokN.Choudhary	1
HinrichSch*tze	EmreVelipasaoglu	1
VanessaP.Braganholo	GabrielaRuberg	1
ErginElmacioglu	Byung-WonOn	1
ShadyShehata	MohamedS.Kamel	2
PhilipS.Yu	HaoHe	1
FlorianVorberger	AlexeyPryakhin	1
MichaelGertz	JieZhang	1
ShengMa	HuiXiong	1
SamikBasu	JyotishmanPathak	1
StephanEwen	HolgerKache	2
MichalisPetropoulos	AlinDeutsch	1
LongboZhang	JiangYun	1
IngoMierswa	AlfredUltsch	1
BenSnyder	BarbaraA.Eckman	1
PhilipS.Yu	PascalFrossard	1
VinayakR.Borkar	AnilMalkani	1
YangZhang	BretHull	1
SimonKamenkovich	CatrielBeeri	1
RunaBhaumik	BamshadMobasher	2
YuZhang	HuajunChen	1
PeterScheuermann	OliviuGhica	1
WenliangDu	HuseyinPolat	1
SteveKelling	RichCaruana	1
YifengZheng	ShirleyCohen	1
Shinn-JangHo	Ming-HaoHung	1
DanielMeziat	A.Viana	1
NikolausAugsten	JohannGamper	1
JunoChang	ByounghoSong	1
ThomasHeinis	CesarePautasso	1
DanielC.Zilio	CalistoZuzarte	1
RonenFeldman	MosheFresko	1
M.Glittum	Hj*rdisHoff	1
ClaudiaPlant	BernhardTilg	1
Sue-ChenHsueh	Sheng-KunHwang	1
YuMeng	MargaretH.Dunham	1
PanosK.Chrysanthis	MohamedA.Sharaf	1
KarthikGomadam	DouglasBrewer	1
YutakaKabutoya	KeishiTajima	1
XiaomingJin	Kwok-YanLam	1
KeithWesnes	ChrisEdgar	1
S.S*nchez	F.Alcojor	1
AnneHunt	AliBahrami	1
HumbertoLuizRazente	CaetanoTrainaJr.	1
VladimirSoroka	IdoGuy	1
XibeiJia	FlorisGeerts	1
DimitriosGunopulos	DemetriosZeinalipour-Yazti	1
TuanD.Pham	StephenT.C.Wong	1
Kuan-WeiChen	Chih-HungHsieh	1
RamKeralapura	JeyashankherRamamirtham	1
BingTianDai	BengChinOoi	1
ArthurZimek	AlexeyPryakhin	1
ZujiaXu	WeiFan	1
XiuliMa	DongqingYang	1
SrujanaMerugu	SaharonRosset	1
E.Sithirasenan	AndrewRau-Chaplin	1
NickKoudas	DimitriosGunopulos	1
MartinEster	FengCao	1
AnthonyTomasic	AnastassiaAilamaki	1
SourashisRoy	LaurentMignet	1
SiQuangLe	LeSyVinh	1
DoinaPrecup	BettinaKemme	1
JudeW.Shavlik	FrankDiMaio	1
MinosN.Garofalakis	FrederickReiss	1
ZhaohuiWu	BinShen	1
LizhengJiang	DongqingYang	1
StephenB.Pope	BiswanathPanda	1
MacarioPolo	IgnacioGarc*aRodr*guezdeGuzm*n	1
YannisVelegrakis	YannisKotidis	1
YehoshuaSagiv	ItzhakFadida	1
Wang-PinHsiung	SongtingChen	3
Min-JaeLee	Jae-GilLee	1
GermanShegalov	DavidB.Lomet	1
YannisPapakonstantinou	AlinDeutsch	2
YunyueZhu	RogerS.Barga	1
ShirleyCohen	JunhyongKim	1
JiuyongLi	AshleyW.Plank	1
Tzung-PeiHong	Chien-HsiangChen	1
KhalidEl-Arini	AndrewW.Moore	1
SusanB.Davidson	JunhyongKim	1
MaximSchwarzkopf	BernhardSeeger	1
MatthewEricOtey	DonaldC.Trost	1
Yi-HongChu	Ming-SyanChen	1
ZhengChen	Hua-JunZeng	1
ZhaohuiWu	WenshengYi	1
PakChungSham	JoshuaZhexueHuang	1
JianPei	JeffreyXuYu	1
MatthiasRenz	ChristianB*hm	2
RayidGhani	KatharinaProbst	1
MingzhuWei	MingLi	2
Ki-HoonLee	EuijongWhang	1
Chen-MingHsu	Baw-JhiuneLiu	1
YuxinMao	HengWang	1
XinPei	BinWu	1
BoualemBenatallah	AixinSun	1
MahbubHassan	BoualemBenatallah	1
WeiJiang	ChrisClifton	1
ColinPuleston	AlanL.Rector	1
WolfgangLehner	PhilippR*sch	1
MichaelJ.Taylor	HugoZaragoza	1
RonnieBathoorn	ArneKoopman	1
KaidiZhao	JeffreyBenkler	2
MichaelJ.Carey	DmitryLychagin	2
CaetanoTrainaJr.	AdrianoS.Arantes	1
XiaoqianJiang	JaideepVaidya	1
VagelisHristidis	GautamDas	1
XueLi	XinYan	1
BernhardGanter	AndreasHotho	1
Ji-WonByun	ElisaBertino	1
WanjingZhang	ClementT.Yu	1
YuchangGong	ShouhongWan	1
TokWangLing	ChangqingLi	2
TuBaoHo	SiQuangLe	1
PeterReutemann	KurtDriessens	1
NarenRamakrishnan	MadhavV.Marathe	1
BenjaminJ.Anderson	AnnaM.Ritz	1
Wei-YingMa	HuanLiu	1
JohnMcPherson	AndreiZ.Broder	1
ApostolosPapadopoulos	AlexandrosNanopoulos	1
ShanWang	BolinDing	1
RogerS.Barga	MohamedF.Mokbel	1
RichCaruana	NamNguyen	1
HongfeiGuo	AlanFekete	1
AristidesGionis	AnttiUkkonen	1
YufengKou	DechangChen	1
Wei-YingMa	LeChen	1
JensTeubner	JanFlokstra	1
DevisBianchini	DeniseSalvi	1
SaharonRosset	RichardD.Lawrence	1
S.Muralidhar	DavidCampbell	1
YingLiu	JunLi	1
BernhardSeeger	AlexanderZeiss	1
RinaPanigrahy	MarcusFontoura	1
PhilipS.Yu	OscarValdivia	1
RalfKlinkenberg	MichaelWurst	1
KeiShiuHo	DikLunLee	1
TomoyoKage	KazutoshiSumiya	1
MirelCosulschi	MihaiGabroveanu	1
YuSuzuki	GuifangDuan	1
ZhenZhang	ChristianA.Lang	1
ZhenHuaLiu	DieterGawlick	1
YutakaHirokawa	TatsuyaMori	1
Wen-SyanLi	VishalS.Batra	1
YongShi	MeihongZhu	1
YoshinariKanamori	DamdinsurenAmarmend	1
HuiSu	HaoLv	1
PhilipA.Bernstein	AlanFekete	1
BoleslawK.Szymanski	AdamMarcus0002	1
HongxingHe	DamienMcAullay	3
WenfeiFan	AnastasiosKementsietsidis	2
VibhutiS.Sengar	ManishBhide	1
StevenC.H.Hoi	MichaelR.Lyu	1
KejunZhu	HaixiangGuo	1
JeffreyChan	JamesBailey	1
JohannesGehrke	JimCordes	1
SouravS.Bhowmick	LingChen0002	2
QianQian	JianhuaFeng	1
YijunLi	WeiminTong	1
Jos*A.Blakeley	DavidCampbell	1
XiangdongZhou	JunqiZhang	1
Jen-WeiHuang	Chi-YaoTseng	1
ShixiaLiu	HaoLv	1
SamuelMadden	MichelGoraczko	1
Kyu-YoungWhang	Il-YeolSong	2
HetalThakkar	ChangLuo	1
KangXie	JuhuaChen	1
Hj*rdisHoff	GeorgeAthanasopoulos	1
ShumingShi	MingjieZhu	1
ManishBhide	D.V.S.Ravikant	1
SrinivasanParthasarathy	GregoryBuehrer	2
HendrikBlockeel	CelineVens	1
FrancescoBonchi	FoscaGiannotti	1
MichaelHerscovici	AndreiZ.Broder	1
ChristopherOlston	AnastassiaAilamaki	1
MelanieOsl	ChristianBaumgartner	1
FrankLeymann	ChristopherM.Johnson	1
ReynoldCheng	JackeyNg	1
YannisTheodoridis	BernhardSeeger	1
SungJinKim	SangHoLee	1
MartinKnoblauch	F.Alcojor	1
ShuguangZhao	JunZhao	1
VishalSikka	P.Anandan	1
YongYang	WanxiaXie	1
JianPei	BaileShi	3
TaoLi	ChrisH.Q.Ding	3
JunZhu	Ji-RongWen	1
NatasaManojlovic	ErikPasche	1
YannisSismanis	BertholdReinwald	1
Zolt*nGy*ngyi	HectorGarcia-Molina	1
PankajK.Agarwal	HaiYu	1
MatthiasNicola	AndreyBalmin	1
PeterWackersreuther	KarstenM.Borgwardt	1
WilsonWong	MohammedBennamoun	1
IvorW.Tsang	Andr*sKocsor	1
Wen-SyanLi	DanielC.Zilio	1
KeWang	HuaShi	1
GrahamCormode	DimitrisSacharidis	1
Shinn-YingHo	Ming-HaoHung	1
PeterR.Pietzuch	JonathanLedlie	1
JanRamon	HendrikBlockeel	1
MarcFriedenberg	JiaLi	1
YongYu	CongShi	1
YannisVassiliou	TimosK.Sellis	1
TomonobuOzaki	TomokiWatanuma	1
WolfgangNejdl	Paul-AlexandruChirita	1
KeithWesnes	GiorgioCorani	1
PengWang	HaixunWang	1
EricP.Xing	Andr*G.R.Balan	1
ManfredHauswirth	KarlAberer	1
YingyiBu	JunLi	1
JunYang0001	BadrishChandramouli	2
M.Tamer*zsu	IhabF.Ilyas	2
ZahraFarzanyar	SattarHashemi	1
WeiminMa	JamesN.K.Liu	1
GaborMelli	BrendanKitts	1
SiweiLuo	LingzhiLiao	1
JianXu	FlipKorn	1
TaroTezuka	KatsumiTanaka	2
MunaAl-Razgan	CarlottaDomeniconi	1
M.Glittum	AphroditeTsalgatidou	1
RobertWingPongLuk	HoChungWu	1
MarcoZaffalon	ChrisEdgar	1
HakanFerhatosmanoglu	AliSamanTosun	1
KaiPuolam*ki	AristidesGionis	1
IsmaelSanz	GiovannaGuerrini	1
V*roniqueBenzaken	GiuseppeCastagna	1
YehoshuaSagiv	BennyKimelfeld	1
Xu-DongZhang	GuangFeng	1
TillWestmann	DmitryLychagin	2
ZuoquanLin	YueMa	1
RodolphePriam	MohamedNadif	1
MihoOhsaki	HidenaoAbe	3
YinYang	MichaelCammert	1
LizhuZhou	GuoliangLi	1
TobiasSunder	NicolasRoper	1
KaoruMaeda	HaraldHolz	1
YaronKanza	Ren*eJ.Miller	1
WesleyM.Hochachka	ArtMunson	1
JaewooKang	Byung-WonOn	1
Yuan-ChiChang	KevinChen-ChuanChang	1
XiangjiHuang	JosiahPoon	1
BinLiu	AmarnathGupta	1
ZhengChen	JunYan	4
MichelGoraczko	HongyiHu	1
Maria-EstherVidal	BarbaraA.Eckman	1
YoshiharuIshikawa	HiroyukiKitagawa	1
WilliamPerrizo	HonglinLi	1
NitinMangal	KamalTiwari	1
ArjmandSamuel	ArifGhafoor	1
Xian-ShengHua	HongJiangZhang	1
SivaGurumurthy	AnupamJoshi	1
JunqiZhang	BaileShi	1
ZheDang	CurtisE.Dyreson	1
SrinivasanParthasarathy	KeithMarsolo	2
GoceTrajcevski	Agn*sVoisard	1
PeterReutemann	ClaireLeschi	1
PrasanRoy	ManishBhide	1
Jia-YuPan	ClaudiaPlant	1
SangKyunCha	C.Mohan	1
QuangHieuVu	H.V.Jagadish	2
GangWu	ChristopherJ.Hughes	1
RizosSakellariou	PaulWatson	1
OmarBenjelloun	ChrisHayworth	1
XiaopengXi	KenUeno	1
StevenBird	HaejoongLee	1
Wen-ChiHou	ChengLuo	2
PetrosManiatis	JosephM.Hellerstein	1
WeiHong	GustavoAlonso	1
LoisM.L.Delcambre	JudithLogan	1
MizuhoIwaihara	LeGruenwald	1
PhilipS.Yu	JoeMcCloskey	1
KrishnaKumaraswamy	DavidM.Steier	1
YihuaWu	S.Muthukrishnan	2
Wen-YuanKu	Jun-WunJou	1
M.Tamer*zsu	KumarGauravBijay	2
TakashiWashio	HiroshiMotoda	2
YufeiTao	XiaokuiXiao	4
YongHongTian	CharlesX.Ling	1
YumingOu	ChengqiZhang	1
SibelAdali	ShawnPearce	1
FoscaGiannotti	DinoPedreschi	1
KatsumiKanasaki	AndreasDengel	1
LingChen0002	JinyanLi	2
AlexMarkov	AbrahamKandel	1
VivekanandGopalkrishnan	GuimeiLiu	1
LinGuo	FanYang0002	1
Maria-EstherVidal	MarelisCardenas	1
ShadiAlShehabi	Jean-CharlesLamirel	1
TaroTezuka	SatoshiOyama	1
PanagiotisSymeonidis	ApostolosPapadopoulos	1
HuaLu	BengChinOoi	1
RalfSchenkel	HolgerBast	1
M.Tamer*zsu	AshrafAboulnaga	2
RuiLi	JinWang	1
RahulShah	JeffreyScottVitter	1
OdedMaimon	LiorRokach	1
XingsenLi	LinglingZhang	1
YuguoLiao	JianhuaFeng	1
YufeiTao	ManLungYiu	1
XindongWu	ChengqiZhang	1
MariosHadjieleftheriou	GeorgeKollios	1
FrankK.H.A.Dehne	D.Green	1
GeorgLausen	Cai-NicolasZiegler	1
YufengKou	Chang-TienLu	1
SonnyVaupel	BernhardSeeger	1
RameshJain	BinLiu	1
RunpingQi	AndreiZ.Broder	1
NiinaHaiminen	AristidesGionis	1
O.Martin	IreneKotsia	1
RonaldGreeley	AshleyDavies	1
ZografoulaVagena	SpirosPapadimitriou	1
ShirishKrishnajShevade	AsharafS	1
ClaudiaPlant	ChristosFaloutsos	1
MauricioA.Hern*ndez	ArielFuxman	1
MatthiasBrantner	Carl-ChristianKanne	2
SunilJigyasu	SujeetBanerjee	1
VolkerMarkl	UtkarshSrivastava	1
EricBrill	ArndChristianK*nig	1
MasahiroKimura	KazumiSaito	1
ShefaliSinghal	JieZhang	1
YukioOhsawa	KenichiHorie	2
QuangHieuVu	Kian-LeeTan	1
Ya-WenHsu	RahulSingh	1
TokWangLing	TianYu	1
MinosN.Garofalakis	DimitrisSacharidis	1
MironLivny	JianshengHuang	1
StevenC.H.Hoi	EdwardY.Chang	1
FarnoushBanaeiKashani	CyrusShahabi	1
BruceM.Maggs	AnastassiaAilamaki	1
RobertoGoglia	CristianDumitrescu	1
JiaLi	JamesZeWang	1
RoniRomano	OdedMaimon	1
ZimingZhuang	RitendraDatta	1
PatrickValduriez	AlexandreA.B.Lima	1
ArnabBhattacharya	AmbujK.Singh	2
PavelDmitriev	GregoryJ.Sharp	1
SeydaErtekin	C.LeeGiles	2
MingshengHong	JohannesGehrke	1
XiaopengXi	StefanoLonardi	1
PhuongNguyen	KunLiu	1
QiaozhuMei	JiaweiHan	2
MeihongZhu	AihuaLi	1
EugeneShih	AllenMiu	1
ValTannen	LucianPopa	1
StefanManegold	PeterA.Boncz	3
Yuan-ChiChang	ChristianA.Lang	1
NaZhao	Mei-LingShyu	1
JonathanKlinginsmith	ArijitSengupta	1
JianPei	JaewooKang	1
MengWang	Li-RongDai	1
TysonCondie	BoonThauLoo	1
LeChen	FengJing	1
Wook-ShinHan	VolkerMarkl	1
YuHirate	IsseiSato	1
Y*celSaygin	ErkaySavas	1
MinHu	ChangqingLi	2
StephenBay	MarkusG.Anderle	1
HongyiHu	EugeneShih	1
Xu-DongZhang	Tie-YanLiu	1
SusanMalaika	JimMelton	1
PhilipS.Yu	HongCheng	1
JuliaDeneva	ChristopherD.Jones	1
RudiBelotti	BeatSigner	1
QiangQiu	JitBiswas	1
JanO.Pedersen	HectorGarcia-Molina	1
Xiang-SunZhang	Shi-HuaZhang	1
VinayakR.Borkar	SachinThatte	1
XuesongMa	DoinaPrecup	1
NachiketaSahoo	GeorgeT.Duncan	1
ClaudiaPlant	ChristianBaumgartner	1
Yi-LingChen	Wei-TaChen	1
TakahiraYamaguchi	HidetoYokoi	1
KeWang	Ee-PengLim	1
TobiasSunder	KlemensB*hm	1
DimitrisTsirogiannis	DimitriosGunopulos	1
PetrosManiatis	DavidE.Gay	1
FlorentMasseglia	AlbertoDelBimbo	1
JennieL.C.Lam	JamesN.K.Liu	1
PascalFrossard	MichailVlachos	1
DonaldKossmann	DanielaFlorescu	1
JinSoungYoo	JamesA.Shine	1
LinQiao	DivyakantAgrawal	1
Yiu-mingCheung	PakChungSham	1
ManjeetRege	FarshadFotouhi	1
RaghuRamakrishnan	PradeepTamma	2
ToonCalders	AdrianaPrado	1
KoustuvDasgupta	AnupamJoshi	1
OlivierBodenreider	HaiyingWang	1
PeterKunath	AlexeyPryakhin	6
KannanGovindarajan	JyotirmayaNanda	1
J*r*meDavid	HenriBriand	1
J*rgSander	GabrielaMoise	1
TamerKahveci	DeepakLachwani	1
T.S.Jayram	PrasadM.Deshpande	1
JiahengLu	BaileShi	1
SougataMukherjea	SivaGurumurthy	1
MarkLast	AbrahamKandel	1
YunyaoLi	HuahaiYang	1
HongCheng	ChengXiangZhai	1
HuiZhang	Han-TaoSong	1
HongSu	DrewDitto	1
WeiyiMeng	HongkunZhao	1
JasonZhang	HuaShi	1
JaapSuermondt	EvanKirshenbaum	1
PadhraicSmyth	ChaitanyaChemudugunta	1
R.MarkGreenwood	AlunD.Preece	1
SergeAbiteboul	PierreSenellart	1
SadokBenYahia	EngelbertMephuNguifo	1
MasashiShimbo	DaichiMochihashi	2
LeonardJ.Seligman	KenSamuel	1
NealFeierabend	DavidT.Potere	1
ZhoujunLi	HuowangChen	1
YongluanZhou	AoyingZhou	1
MichaelStonebraker	JoachimHammer	1
ZhaohuiPeng	LuQin	1
TieyunQian	HuiXiong	1
Y*celSaygin	Ay*aAzginHintoglu	1
ShenghuaBao	HangLi	1
XiaoweiXu	MutluMete	1
MichaelReichert	ManishBhide	1
JasonV.Davis	InderjitS.Dhillon	1
TarasRafa	ChihLai	1
RogerS.Barga	DavidB.Lomet	2
MariaCamilaNardiniBarioni	CaetanoTrainaJr.	1
MauricioA.Hern*ndez	C.T.HowardHo	1
SergeiEvdokimov	OliverG*nther	1
WanxiaXie	ShamkantB.Navathe	1
KeithC.C.Chan	EricM.H.Lee	1
Ren*eJ.Miller	PeriklisAndritsos	1
SujeevanAseervatham	AomarOsmani	1
Hyun-SookLee	Han-DeokLee	1
DushyanthNarayanan	AustinDonnelly	2
WilliamY.Arms	DanielRiley	1
RakeshAgrawal	MuratKantarcioglu	1
PradeepTamma	Bee-ChungChen	1
MarianneWinslett	LarsE.Olson	1
NoamPalatin	AssafSchuster	1
NicholasGerner	JayavelShanmugasundaram	1
ChristosTjortjis	ChristosMakris	1
JiaruiNi	ChengqiZhang	1
YunmingYe	GrahamJ.Williams	1
SebastianMichel	MatthiasBender	3
PrasadM.Deshpande	DouglasBurdick	1
SongWang	MuraliMani	2
GangWu	EdwardY.Chang	1
JohnLangford	BiancaZadrozny	1
IzchakSharfman	DanielKeren	1
YunmingYe	JoshuaZhexueHuang	1
TiankaiTu	StratosPapadomanolakis	1
MuratAliBayir	IsmailHakkiToroslu	1
YvonneMorrow	ChengqiZhang	1
TerryCaelli	NianjunLiu	1
MichelGoraczko	EugeneShih	1
VassiaPavlaki	FotoN.Afrati	1
Ming-SyanChen	Jen-WeiHuang	2
SureshVenkatasubramanian	DiveshSrivastava	1
XuanZheng	MarkDaly	1
TakeshiSuzuki	KatsumiKanasaki	1
MichailVlachos	MariosHadjieleftheriou	1
FengShao	ChavdarBotev	1
XueminLin	JeffreyXuYu	1
VinayakR.Borkar	NicolaOnose	1
ShanWang	JunZhang	1
QiangYang	NingLiu	1
NikosMamoulis	HuipingCao	1
SvenHelmer	GuidoMoerkotte	1
StefanSeltzsam	AlfonsKemper	1
VanaKalogeraki	SharmilaSubramaniam	1
CarlaSchlatterEllis	AdamSilberstein	1
MirekRiedewald	AndersRyd	1
RiccardoMartoglia	FedericaMandreoli	2
YongHu	MeiLiu	1
TomohiroYoshihara	HaruoYokota	2
Shinn-JangHo	Chih-HungHsieh	1
MonaWong-Barnum	LisaFong	1
H.V.Jagadish	CongYu	2
YingZhou	XinChen	1
ThomasHeinis	GeorgeAthanasopoulos	1
GiuseppeM.Mazzeo	CristinaSirangelo	1
JiongYang	GeorgeKarypis	1
KostyantynM.Shchekotykhin	GerhardFriedrich	1
TieyunQian	EnhongChen	1
ReynoldCheng	JeffreyScottVitter	1
XiaopengXi	JinShieh	1
Han-ShenHuang	Bo-HouYang	1
WeiHong	MichaelJ.Franklin	1
SouravS.Bhowmick	MizuhoIwaihara	1
ShuigengZhou	JoshuaZhexueHuang	1
XingquanZhu	XindongWu	1
XuweiLiang	ShiyongLu	1
SihemAmer-Yahia	AlinDeutsch	1
ChristianB*hm	ArthurZimek	2
DianeJ.Cook	ChangHunYou	1
ShivnathBabu	JeffreyS.Chase	1
MujdePamuk	MichaelStonebraker	1
NickCraswell	ChrisBurges	1
WeiWang0010	SusanPaulsen	1
RuomingJin	GaganAgrawal	2
RodneyWolff	CalumRobertson	1
YiLu	StephenA.Krawetz	1
DimitriosGunopulos	BenjaminArai	1
TatsuoTsuji	MasakazuKumakiri	1
JanRamon	CelineVens	1
JunLi	AihuaLi	1
KaiPuolam*ki	AnttiUkkonen	1
WalidG.Aref	MohamedG.Elfeky	1
TakashiKobayashi	HaruoYokota	2
PeterA.Boncz	JensTeubner	2
ShusakuTsumoto	ShojiHirano	2
SharadMehrotra	NaliniVenkatasubramanian	1
QuamrulI.Khan	CarsonKai-SangLeung	1
MohamedG.Elfeky	AhmedK.Elmagarmid	1
SujuRajan	JoydeepGhosh	1
SebastianB*ttger	KarstenM.Borgwardt	1
GlenNewton	BeibeiZou	1
TysonCondie	PetrosManiatis	1
ZhanhuaiLi	LongboZhang	1
MarkDaly	DavidWalker	1
DavidJ.Martin	AshwinMachanavajjhala	1
ThomasB.Hodel-Widmer	StefaniaLeone	1
Hsiao-DongChiang	BalaRajaratnam	1
JohannesGehrke	DavidJ.Martin	1
MarkLast	AlexMarkov	1
ChristianGarcia-Arellano	AdamJ.Storm	1
DavideMartinenghi	AlessandroRaffio	1
YangZhang	HongyiHu	1
VijayshankarRaman	AmolDeshpande	1
Tie-YanLiu	GuoyangShen	1
KunalPunera	JoydeepGhosh	1
TaoChen	Dit-YanYeung	1
MarcoSaerens	LuhYen	1
Ming-SyanChen	Kun-TaChuang	2
PedroTrancoso	Josep-LluisLarriba-Pey	1
VibhoreKumar	SangeethaSeshadri	1
RayidGhani	CarlosSoares	1
ShengWang	JeffreyXuYu	1
Ee-PengLim	BoualemBenatallah	1
XiaodanSong	BelleL.Tseng	1
YingFeng	PingWu	1
BenY.Zhao	AmrElAbbadi	1
MichaelI.Dekhtyar	AlexDekhtyar	1
WilliamY.Arms	DavidA.Lifka	1
PeterKunath	PeerKr*ger	5
WeifengSu	QiongHuang	1
JianliangXu	BaihuaZheng	2
NadirWeibel	MichaelGrossniklaus	1
Yen-KuangChen	GangWu	1
YuefengLi	EstherGe	1
RiccardoRizzo	AntoninoFiannaca	1
GuadalupeCanahuate	AliSamanTosun	1
RaghuRamakrishnan	PaulBarford	2
YangZhang	VladimirBychkovsky	1
YanguZhang	WenshengYi	1
JianYin	HaixunWang	1
RafaelBerlangaLlavori	MarcoMesiti	1
GalShafirstein	Chun-YangFan	1
UtkarshSrivastava	AhmedAyad	1
RajeevMotwani	AmrutaJoshi	1
NicolaOnose	DmitryLychagin	1
ZhengZhang0002	YaronKanza	1
TovaMilo	CatrielBeeri	1
Chang-TienLu	ArnoldP.Boedihardjo	1
ThemisPalpanas	IoanaStanoi	1
HeliHiisil*	AristidesGionis	1
SvenGroppe	JinghuaGroppe	1
JenniferL.Beckmann	JeffreyF.Naughton	1
TerryGaasterland	BarbaraA.Eckman	1
YiChen	SusanB.Davidson	2
MarioPiattini	Bel*nVela	1
Yiu-mingCheung	SioIongAo	1
RebeccaCasta*o	NghiaTang	1
TilmannF.W.Bruckhaus	CharlesX.Ling	1
KensukeOhta	DaiKobayashi	1
YifengShao	ShicongMeng	1
WesleyM.Hochachka	SteveKelling	1
UpendraV.Chaudhari	LisaAmini	1
KunalPunera	AndrewTomkins	1
SongtingChen	Hua-GangLi	2
ZhiZhou	TiejunHuang	1
NayerM.Wanas	DinaA.Said	1
Wei-kengLiao	AlokN.Choudhary	1
FrankS.Spear	BouchraBouqata	1
ShubhaU.Nabar	ChrisHayworth	1
WitoldAbramowicz	MarekKowalkiewicz	1
PushengZhang	LiqinZhang	1
VijayshankarRaman	StephanEwen	2
TerryCaelli	MichaelJ.Hill	1
YingXu0002	VanjaJosifovski	1
NickKoudas	DiveshSrivastava	5
RamasamyUthurusamy	K.P.Unnikrishnan	1
StephenFisher	JunhyongKim	1
TatjanaScope	BrittaSt*rmann	1
PaulS.Katz	HaoTian	1
StavrosHarizopoulos	AnastassiaAilamaki	2
K.Sel*ukCandan	Hua-GangLi	2
DavidA.Lifka	DanielRiley	1
KwangJinPark	Chong-SunHwang	1
MichaelK.Ng	KevinY.Yip	1
TilmannF.W.Bruckhaus	NazimH.Madhavji	1
SamahJamalFodeh	H.D.K.Moonesinghe	1
RakeshAgrawal	JerryKiernan	1
XueminLin	HengTaoShen	1
ToddC.Mowry	AmitManjhi	1
Jia-YuPan	HanghangTong	1
YitzhakMandelbaum	KathleenFisher	1
HongSu	DineshDas	1
WilliamL.Barth	KarlW.Schulz	1
SimonC.K.Shiu	BoFeng	1
AmitabhChaudhary	AlecPawling	1
PhilippeThiran	FabriceEstievenart	1
XiaopengXi	LiWei	3
YingqiXu	Wang-ChienLee	1
XiaojingYuan	KunZhang	2
TaneliMielik*inen	PanayiotisTsaparas	2
ParagAgrawal	ChrisHayworth	1
LiWei	JinShieh	1
Ugur*etintemel	StanleyB.Zdonik	1
LeiTang	JianpingZhang	1
YoshinobuYamashita	MamoruHoshi	1
ElkeAchtert	ChristianB*hm	5
LuhYen	Fran*oisFouss	1
VijayGopalakrishnan	BobbyBhattacharjee	1
YingXu0002	AndrewTomkins	1
JerryScripps	HaibinCheng	1
ManfredHauswirth	AliSalehi	1
KaiXu0003	HengTaoShen	1
RamaswamyHariharan	NaveenAshish	1
YanHuang	LiqinZhang	1
NorihikoIto	HironobuYamasaki	1
ShamikSural	ArunK.Majumdar	1
WolfgangNejdl	ClaudiuS.Firan	1
SalvatoreOrlando	FoscaGiannotti	1
M.MahdiShafiei	EvangelosE.Milios	1
OliverFritzen	DanielSchubert	1
XiaokuiXiao	ShuigengZhou	1
NiinaHaiminen	EvimariaTerzi	1
MohammedJ.Zaki	GeorgeKarypis	1
ShixiaLiu	HuiSu	1
SebastianB*ttger	Hans-PeterKriegel	1
JerryKiernan	ChristopherM.Johnson	1
ZhenZhang	Yuan-ChiChang	1
SibelAdali	MariaLuisaSapino	1
Jo-ChunChuang	ArbeeL.P.Chen	1
MuthuramakrishnanVenkitasubramaniam	DavidJ.Martin	1
PhilipS.Yu	ChenChen	1
StefanoLonardi	EamonnJ.Keogh	1
SamirKhuller	LouiqaRaschid	1
TorstenSteinbach	LaurentMignet	1
OuriWolfson	HuCao	1
RaviKumar	KunalPunera	1
HeikoJahnkuhn	AmmarBalouch	1
YimingMa	NaliniVenkatasubramanian	1
WolfgangJank	ShanshanWang	1
RebeccaCasta*o	BenjaminCichy	1
PhilipS.Yu	HaixunWang	4
Wen-ChiHou	QiangZhu	1
YalingPei	OsmarR.Za*ane	1
JunYang0001	HaixunWang	1
OlegRostanin	KaoruMaeda	1
PaoloMissier	BinlingJin	1
RonenFeldman	ChabaneDjeraba	2
VinayakR.Borkar	DmitryLychagin	2
ZhaohuiZheng	HongyuanZha	1
StefanoLonardi	JinShieh	1
VishalSikka	MeichunHsu	1
HongyuanZha	DingZhou	3
GabrielPuiCheongFung	DavidW.Cheung	1
Yo*lleS.Maarek	VladimirSoroka	1
JoydeepGhosh	AlexanderLiu	1
MasakazuKumakiri	LiBei	1
Si-weiGao	HaixiangGuo	1
VenkateshGanti	KaushikChakrabarti	1
L.PaulChew	JohannesGehrke	1
JiaweiHan	ChaoLiu0001	3
TaichiMuraki	HideakiTakeda	1
ZhengChen	HuiZhao	1
ZhengChen	DouShen	4
MarioAntonioletti	AmyKrause	1
KlausR.Dittrich	ChristophSturm	3
ToddC.Mowry	ChristopherOlston	1
TimmEuler	RalfKlinkenberg	1
YiyaoLu	WanjingZhang	1
JosephM.Hellerstein	BoonThauLoo	1
PramodSingh	A.CharlesThomas	1
RangaRajuVatsavai	LaurentMignet	1
SougataMukherjea	KoustuvDasgupta	1
HernaL.Viktor	EricPaquet	1
KevinY.Yip	ChunKitChui	1
RaduStefanNiculescu	R.BharatRao	1
WeiWang0009	BaileShi	6
SelcukAya	PavelDmitriev	1
KlausBerberich	GerhardWeikum	1
J*rgenKr*mer	ChristophHeinz	1
LarsBackstrom	JonM.Kleinberg	1
PedroTrancoso	JosepAguilar-Saborit	1
Hans-PeterKriegel	AlexeyPryakhin	7
PaulS.Katz	HongYang	1
LiqianZou	GuangWang	1
S.S*nchez	MartinKnoblauch	1
SungRanCho	NickKoudas	1
TimothyRoscoe	IonStoica	1
DavidR.Musicant	AnnaM.Ritz	1
Xu-YingLiu	JianxinWu	1
Pu-JenCheng	Chen-MingHung	1
MartinEster	ByronJ.Gao	4
EmmanuelViennet	AomarOsmani	1
LeonidGlimcher	GaganAgrawal	1
SteveA.Chien	DominicMazzoni	1
KiyokoF.Aoki-Kinoshita	HiroshiMamitsuka	1
PeterReutemann	BernhardPfahringer	1
WangYong	JiangYun	1
ZeinaKoteiche	MarcelKaram	1
MingJiang0003	ElkeA.Rundensteiner	2
ElenaFerrari	BarbaraCarminati	1
LeiZhang	BerndWachmann	1
Jes*sS*nchezCuadrado	Jes*sGarc*aMolina	1
RamasamyUthurusamy	NarenRamakrishnan	1
AnnikaHinze	Agn*sVoisard	1
KoustuvDasgupta	AmitAnilNanavati	1
S.Muralidhar	Jos*A.Blakeley	1
MichaelD.Smith	KathleenT.Durant	1
ValentinKuznetsov	ChristopherD.Jones	1
ThomasSeidl	BorisGlavic	1
EvangelosKanoulas	DonghuiZhang	1
ShubhaU.Nabar	NinaMishra	1
Shinn-YingHo	Jun-WunJou	1
YunyaoLi	H.V.Jagadish	1
TamaraA.Schwimmer	JonathanC.Yang	1
TheophanoMitsa	DajunWang	1
RobertoTrasarti	FrancescoBonchi	1
PierluigiDelNostro	PaoloAtzeni	1
TharamS.Dillon	LingFeng	1
NavenduJain	HenriqueAndrade	1
KimutaiKimeli	DongDongZhang	1
SongLin	DimitriosGunopulos	1
KiyoshiKogure	HiromiItohOzaku	1
JayavelShanmugasundaram	FranzFaerber	1
Wei-YingMa	Tie-YanLiu	4
WynneHsu	LimsoonWong	1
WalidG.Aref	ThanaaM.Ghanem	1
AnandRajaraman	AlonY.Halevy	1
SumitNegi	GaneshRamakrishnan	1
JiaweiHan	HongyanLiu	3
ZhenjieZhang	CheeYongChan	2
Vicen*Soler	MartaPrim	1
SunilJigyasu	KanadDixit	1
SayaV.Nagori	HyoilHan	1
Sang-HeeLee	LiWei	1
YuefengLi	YueXu	3
RebeccaBraynard	KameshMunagala	1
WenfeiFan	EimanElnahrawy	1
RajeevMotwani	AndrewTomkins	1
JilinChen	BenyuZhang	1
YanRuiHuang	AijunAn	1
SitaramAsur	*mitV.*ataly*rek	1
VinayakR.Borkar	KanadDixit	1
RyoichiKawahara	KimihiroYamamoto	1
DyceJingZhao	DikLunLee	1
Y*celSaygin	AlbertLevi	1
ZhihaiWang	LianweiZhao	1
PetraKralj	GemmaC.Garriga	1
HariBalakrishnan	EugeneShih	1
RaviKumar	RajeevMotwani	1
MinosN.Garofalakis	JosephM.Hellerstein	2
JinpingZheng	Chang-TienLu	1
JohannesGehrke	ChristopherD.Jones	1
GangWu	CanLiu	1
JohnW.Lockwood	JamesMoscola	1
XiangyeXiao	Wei-YingMa	1
PhilippeSelo	LisaAmini	1
HangLi	BinGao	1
XinPei	BaiWang	1
ThemisPanayiotopoulos	SpyrosVosinakis	1
ShadyShehata	FakhriKarray	2
ZhaohuiPeng	JunZhang	1
TaoLi	Chang-ShingPerng	1
LeiZhang0001	FengJing	1
MorHarchol-Balter	BiancaSchroeder	2
KeiYuasa	HarumiA.Kuno	1
ZhaoJian	GuanYi	1
VictorVianu	DayouZhou	1
XiaojingYuan	WeiFan	2
LiqianZou	GregButler	1
JimGray	DineshManocha	1
Zhi-QiangLiu	JianhuaFeng	1
RakeshAgrawal	EvimariaTerzi	2
PeterKunath	JohannesA*falg	3
YutakaHirokawa	KeisukeIshibashi	1
SantiagoMeli*	MarcelaGenero	1
RichCaruana	DanielFink	1
JinboBi	JiepingYe	1
ToshiroKubota	R.BharatRao	1
StephenD.Scott	KunDeng	1
CristianDumitrescu	AntonioAlbano	1
WenshengYi	MinYao	1
FabrizioSilvestri	DiegoPuppin	1
LiBei	KenHiguchi	1
BruceM.Maggs	AmitManjhi	1
HuaWang	AshleyW.Plank	1
ArisAnagnostopoulos	AndreiZ.Broder	1
XueyanTang	Wang-ChienLee	1
RamyaRangarajan	KalyanBeemanapalli	1
Mong-LiLee	ChangSheng	2
DavidR.Musicant	BenjaminJ.Anderson	1
PascalFrossard	OlivierVerscheure	1
ManjaNelius	AmmarBalouch	1
Jau-MinWong	Chun-ChihLiao	1
JamesP.Rogers	CarlottaDomeniconi	1
DongqingYang	DehuiZhang	1
SrinivasanParthasarathy	AmolGhoting	3
YongShi	GuangliNie	1
UlfLeser	ThorstenVitt	1
YingChen	FrankK.H.A.Dehne	1
SreenivasGollapudi	RinaPanigrahy	2
LoredanaAfanasiev	EnricoZimuel	1
Kuan-WeiChen	Hui-LingHuang	1
MinYao	BinShen	1
Bj*rnBringmann	AlbrechtZimmermann	1
PaulW.Purdom	DirkVanGucht	1
SamYuanSung	HuiXiong	1
LingpengYang	GuodongZhou	1
YaboXu	RongShe	1
MohammedJaveedZaki	GregoryPiatetsky-Shapiro	2
RichardMortier	DushyanthNarayanan	2
ValentinKuznetsov	JuliaDeneva	1
HansungLee	DaiheePark	1
StefanBrecheisen	PeterKunath	1
YanLiu0002	AndrewE.Fano	1
MatthewEricOtey	AmolGhoting	1
XiaojingYuan	JingWang0007	1
NicolaOnose	AlinDeutsch	1
JinzeLiu	AndrewB.Nobel	1
ThomasWolf	BenediktBrors	1
HeikkiMannila	EllaBingham	1
SeokIlSong	KyoungSooBok	1
JimMelton	AndrewEisenberg	1
JingliLu	ChengqiZhang	1
XiaoyuanWang	AdaWai-CheeFu	2
SalvatoreOrlando	RobertoTrasarti	1
YuelongJiang	AlexanderTuzhilin	1
Wang-PinHsiung	DivyakantAgrawal	3
ZengyouHe	JoshuaZhexueHuang	1
SivaGurumurthy	GautamDas	1
WilliamY.Arms	AndersRyd	1
RajuganRajagopalapillai	J.WennyRahayu	1
StephanBloehdorn	AlessandroMoschitti	1
ShaozhiYe	Ji-RongWen	1
ZivBar-Yossef	VladimirSoroka	1
ShashiShekhar	EricD.Kolaczyk	1
MingzhuWei	DrewDitto	1
MicheleGorgoglione	CosimoPalmisano	1
ThomasWolf	ElisabethGeorgii	1
SvenLaur	HelgerLipmaa	1
VladimirBychkovsky	EugeneShih	1
RobertM.Bell	ChrisVolinsky	1
VolkerTresp	Hans-PeterKriegel	1
JieChen	ChristineM.O'Keefe	1
PaulWatson	AlvaroA.A.Fernandes	1
ZhongfeiZhang	RameshJain	1
JamieCallan	GeorgeT.Duncan	1
TakashiOnoda	HironobuYamasaki	1
YumaoLu	VwaniP.Roychowdhury	1
TongZhang	ByronDom	1
ZhihuaZhang	AnkurJain	1
SucharitaGopal	ShashiShekhar	1
EugeneShih	BretHull	1
YongYu	ShenghuaBao	2
DavidJensen	ChiragShah	1
DavidChu	AmolDeshpande	1
TongZhang	AlexandrinPopescul	1
MauricioA.Hern*ndez	LucianPopa	1
SimonLaws	NormanW.Paton	1
MohamedS.Kamel	FakhriKarray	2
NanDu	BaiWang	1
YangZhang	KevinChen	1
MohamedAly	KirkPruhs	1
TharamS.Dillon	FedjaHadzic	3
NadirWeibel	MoiraC.Norrie	1
SureshVenkatasubramanian	AndrewMcGregor	1
JulianaFreire	AltigranSoaresdaSilva	1
PabitraMitra	NitinGupta	1
ThemisPanayiotopoulos	NikosPelekis	1
QiangZhu	AdegokeOjewole	1
MeichunHsu	C.Mohan	1
ClementT.Yu	A.PrasadSistla	1
PaolaPodest*	AlbertoBelussi	1
NobuhisaUeda	MinoruKanehisa	1
Young-KooLee	Kyu-YoungWhang	1
GuozhengXiao	GuodongZhou	1
VijayGandhi	ShashiShekhar	1
CharuC.Aggarwal	BoZhang0002	1
Seok-WonSeong	JoachimHammer	1
XiaodanZhang	XiaLin	1
ZhengyuanZhu	DeepakAgarwal	1
JenniferWidom	GustavoAlonso	1
VladimirPavlovic	Pai-HsiHuang	1
Pang-NingTan	H.D.K.Moonesinghe	1
MichaelJ.Franklin	AlonY.Halevy	1
SimeonWarner	PaulGinsparg	1
PingChen	ChengminDing	1
YanLiu0002	KatharinaProbst	1
JamesT.Kwok	IvorW.Tsang	1
ThomasHeinis	Arne-J*rgenBerre	1
ZhiyongHuang	H.V.Jagadish	1
YanZhang	XingquanZhu	1
YapingLi	MuratKantarcioglu	1
Wei-ChuanLiu	Ken-HaoLiu	1
WolfgangLehner	RainerGemulla	3
ShiweiTang	AiqiangGao	1
Xue-MeiNing	Hong-WeiLiu	1
S.Muthukrishnan	GrahamCormode	1
YaliZhu	BinLiu	1
MichaelH.B*hlen	AndrejTaliun	1
UlrichWagner	AttilaGyenesei	1
VolkerTresp	KaiYu	1
XifengYan	PhilipS.Yu	2
ScottSirowy	LiWei	1
KentaFukata	HiroshiMotoda	1
YifengZheng	HaejoongLee	1
JinSoungYoo	JamesP.Rogers	1
HaixunWang	BaileShi	1
RafaelPe*aloza	Lo*cRoyer	1
K.SjoerdMullender	JanRittinger	1
KeWang	DaymondLing	1
Zheng(Jessica)Zhao	WendyHuiWang	1
W.BruceCroft	DavidJensen	1
RicardoMardales	DinaQ.Goldin	1
PhilippeSelo	NavenduJain	1
YongYang	SushilK.Prasad	1
RiteshKumar	DineshManocha	1
JohnShepherd	AnneH.H.Ngu	1
YangSong	IsaacG.Councill	1
ZhiyongHuang	ShuqiaoGuo	1
NanCao	HuiSu	1
TiffanyDohzen	MujdePamuk	1
BruceM.Maggs	AnthonyTomasic	1
ShankarPal	BrandonBerg	1
NormanW.Paton	AndrewEisenberg	1
RunaBhaumik	ChadWilliams	2
XiaopengXi	Dah-JyeLee	1
YannisE.Ioannidis	KonstantinosMorfonios	1
ZsoltTivadarKardkov*cs	FerencSzidarovszky	1
TongSun	EamonnJ.Keogh	1
YanleiDiao	ShariqRizvi	1
PaulGinsparg	JohannesGehrke	1
JamesZeWang	DhirajJoshi	1
YokoKamidoi	NoriyoshiYoshida	1
RuiWang0002	DavidB.Lomet	1
JieChen	GrahamJ.Williams	1
RichCaruana	MirekRiedewald	1
VolkerHeun	JohannesFischer	1
ElisaQuintarelli	CarloCurino	1
PeterScheuermann	HuiDing	1
RajendraBose	IanT.Foster	1
ShuguangZhao	MingyingZhao	1
KevinChen-ChuanChang	ChristianA.Lang	1
KeWang	AlexanderTuzhilin	1
VagelisHristidis	NishantKapoor	1
KaiSimon	Cai-NicolasZiegler	1
Jo*oFranciscoValiati	BartKuijpers	1
QiangYang	DouShen	4
Kian-LeeTan	HengTaoShen	1
GuodongZhou	Dong-HongJi	1
Jae-GilLee	EuijongWhang	1
XiaoyunWu	BoLong	1
LiChen	AmarnathGupta	1
UtkarshSrivastava	JenniferWidom	1
ZaiqingNie	Ji-RongWen	3
Zo*Lacroix	Maria-EstherVidal	2
MohammedJ.Zaki	JiongYang	1
MemaRoussopoulos	MattWelsh	1
XueyanTang	Ee-PengLim	1
O.Garc*a	A.Viana	1
NanJiang	LeGruenwald	2
TheoniPitoura	PeterTriantafillou	1
FatihEmek*i	AmrElAbbadi	1
VictorVianu	AlinDeutsch	1
WyattT.Clark	MehmetM.Dalkilic	1
NaokiAbe	HisashiKashima	1
MarcosSalganicoff	GlennFung	1
VanaKalogeraki	BenjaminArai	1
NatasaManojlovic	FriedrichMayer-Lindenberg	1
Wen-ChiHou	FengYan	1
PingLi	KennethWardChurch	1
TimosK.Sellis	SpyrosPassas	1
RussellGreiner	Chi-HoonLee	1
XiaofengZhu	JilianZhang	1
JohnYen	HongyuanZha	1
XiaokuiXiao	JianPei	1
YanongZhu	MingLi	1
JayavelShanmugasundaram	FanYang0002	3
ZhengZhang	AoyingZhou	2
SameepMehta	RaghuMachiraju	1
WeipingWang0001	DongDongZhang	1
Seung-TaekPark	DennisDeCoste	1
NealFeierabend	NagendraSingh	1
ChadWilliams	BamshadMobasher	2
JenniferL.Beckmann	AlanHalverson	1
Yiu-mingCheung	MichaelK.Ng	1
RomansKasperovics	MichaelH.B*hlen	1
EduardC.Dragut	A.PrasadSistla	1
PhilippeBouch*	NabilBenayadi	1
TaoChen	GangWang	1
SebastianRichly	DirkHabich	1
PavelDmitriev	CarlLagoze	1
SourashisRoy	RangaRajuVatsavai	1
GeraldoXex*o	EduardoBezerradaSilva	1
Hung-MingChen	Chih-HungHsieh	1
PraveenRao	BongkiMoon	1
RezaSherkat	DavoodRafiei	1
S.S*nchez	DanielMeziat	1
YimingMa	RamaswamyHariharan	1
VishalS.Batra	MahadevanSubramanian	1
JouniK.Sepp*nen	HannesHeikinheimo	1
SabineLoudcherRabas*da	OmarBoussaid	1
TaufikAbidin	AijuanDong	1
GerdHeber	DavidR.O'Hallaron	1
HeungkyuLee	HanseokKo	1
JiaweiHan	DongXin	9
GiuseppeCastagna	DarioColazzo	1
GregoryJ.Sharp	AndersRyd	1
WeipingWang0001	JianzhongLi	1
SangKyunCha	HonestyC.Young	1
SriramMohan	JonathanKlinginsmith	1
MirekRiedewald	JuliaDeneva	1
KameshMunagala	CarlaSchlatterEllis	1
JacobD.Furst	DavidS.Channin	1
SrinivasanParthasarathy	ShirishTatikonda	1
VladimirCherkassky	JinboBi	1
ZheweiJiang	ChengLuo	2
VanjaJosifovski	AndreiZ.Broder	1
PhilipA.Bernstein	PaoloAtzeni	1
PradeepTamma	HongfeiGuo	1
MinhoSung	JiaWang	1
JiaweiHan	FeidaZhu	1
MitchCherniack	AnuragMaskey	1
PhilippeThiran	Jean-LucHainaut	1
MichaelR.Berthold	AntoninoFiannaca	1
NavenduJain	ChitraVenkatramani	1
XinqiangZuo	JianminWang	1
MengWang	HongJiangZhang	1
LawrenceH.Reeve	HyoilHan	1
GeertJanBex	FrankNeven	1
StanleyB.Zdonik	Jeong-HyonHwang	1
IhabF.Ilyas	ChengkaiLi	1
MiaoWen	JosiahPoon	1
LauraBright	BillHowe	1
RussellGreiner	JiayuanHuang	1
AnastasiosGounaris	AlvaroA.A.Fernandes	1
MohamedZa*t	AndrewWitkowski	1
OlfaNasraoui	BamshadMobasher	1
YeTian	GaryM.Weiss	1
W.P.Weiss	MarcFriedenberg	1
YehudaKoren	ChrisVolinsky	1
ZahraFarzanyar	MohammadRezaKangavari	1
SubhashSuri	JohnHershberger	1
WoochangHwang	AidongZhang	1
KevinChen	HongyiHu	1
TakanobuNakahara	HiroyukiMorita	1
SrinivasanParthasarathy	SameepMehta	2
RuiZhou	GuorenWang	1
LouiqaRaschid	BenSnyder	1
BhavaniRaskutti	AlanHerschtal	1
Mong-LiLee	JinChen	1
LeahE.Steinberg	DavidR.Musicant	1
SaberJahanpour	AlirezaMokhtaripour	1
ToshiroKubota	KazunoriOkada	1
TatjanaScope	AndreasKupfer	1
WeiWang0009	HaixunWang	1
MukeshSinghal	Gail-JoonAhn	1
RobertoBasili	MarcoCammisa	1
LouisLicamele	LiseGetoor	2
JiaWang	AbhishekKumar	1
StefanBrecheisen	MatthiasSchubert	1
KlausR.Dittrich	ChristophKiefer	2
FilippoFurfaro	BettinaFazzinga	1
Young-RaeCho	WoochangHwang	1
MaximKormilitsin	GangGou	1
ShashiShekhar	MeteCelik	2
PilarParra	A.Viana	1
ShenodaGuirguis	AlaaeldinM.Hafez	1
RalfRantzau	ChristophMangold	1
Ming-ChienShan	FabioCasati	1
JaideepVaidya	HwanjoYu	1
MinhoSung	ErranL.Li	1
JimCordes	DavidA.Lifka	1
YuniXia	RahulShah	1
YijianBai	ShaorongLiu	1
TaoJiang	Ah-HweeTan	1
MatteoAlbertoSorrenti	GiovannaGuerrini	1
JulianaFreire	EmanueleSantos	2
NickKoudas	BingTianDai	1
BernardJ.Jansen	AmandaSpink	1
NaliniVenkatasubramanian	DmitriV.Kalashnikov	1
Zo*Lacroix	LouiqaRaschid	2
VerenaKantere	IlujuKiringa	1
LuisHoyos	Jos*A.Cars*	1
YuefengLi	WanzhongYang	1
RongShe	JianPei	1
JianWen	HuowangChen	1
Kun-TaChuang	Jen-WeiHuang	1
SunmeeKang	HeungkyuLee	1
Jung-RaeHwang	Chan-HyunKang	1
ErkaySavas	AliInan	1
HangLi	BingLiu	1
YuanzhenWang	TieyunQian	1
LuQin	BolinDing	1
YutakaKabutoya	KatsumiTanaka	1
YunhaoLiu	LeiChen0002	1
QuinnHart	MichaelGertz	1
PascalPoncelet	MaguelonneTeisseire	1
Dae-WonKim	Bo-YeongKang	1
Tam*sHorv*th	JanRamon	1
Mong-LiLee	MinghuaZhang	1
RoyGr*nmo	CesarePautasso	1
ReynoldCheng	MichaelChau	2
TerryCaelli	RobLesslie	1
Mong-LiLee	GaoCong	1
TaneliMielik*inen	NikolajTatti	1
JagannathanSrinivasan	EugeneInseokChong	1
ShichaoZhang	JilianZhang	1
KevinWilkinson	JyotirmayaNanda	1
YaoWu	LouiqaRaschid	2
XinChen	Wei-bangChen	1
HongyuGuo	EricPaquet	1
ElenaLazkano	AitzolAstigarraga	1
ReynoldCheng	ChunKitChui	1
Jo-ChunChuang	Chung-WenCho	1
RobertoGoglia	LucioGoglia	1
HongYang	HaoTian	1
XiaoyunHui	HuanHuo	1
SusanaMontero	LauraMontellsHiguero	1
RaghuRamakrishnan	LeiChen0003	2
VasilisVassalos	ProdromosMalakasiotis	1
RafiAhmed	MohamedZa*t	1
W.JohnWilbur	RezartaIslamajDogan	1
Jos*Mar*aMart*nez-Otzeta	BasilioSierra	1
WoohyunKim	In-YoungKo	1
MakotoKataigi	HaruoYokota	1
SelcukAya	ChristopherD.Jones	1
PhilippePicouet	BenjaminBuffereau	1
XinqiangZuo	Kwok-YanLam	1
JunRao	C.Mohan	1
Yoo-SungKim	Kyong-IKu	1
NevinM.Darwish	NayerM.Wanas	1
JohnRiedl	GeorgeKarypis	1
TomotakeNakamura	Shin'ichiWakabayashi	1
RicardoA.Baeza-Yates	*lvaroR.PereiraJr.	1
RobertJ.Calin-Jageman	RajshekharSunderraman	1
VolkerHeun	StefanKramer	1
ZhaohuiWu	YuZhang	1
RizosSakellariou	JimSmith	1
YanSong	Xian-ShengHua	1
SteveA.Chien	RonaldGreeley	1
TianXia	DonghuiZhang	4
XiaoyunHui	RuiZhou	1
NormanW.Paton	MarioAntonioletti	1
TomohiroYoshihara	MakotoKataigi	1
TaoXiong	RaviJanardan	2
KangRyoungPark	DaeWoongRhee	1
Y*celSaygin	AliInan	1
JimengSun	EvanHoke	1
HuaLi	DouShen	1
Zhi-QiangLiu	LizhuZhou	1
YingYan	AoyingZhou	1
GautamDas	DimitrisTsirogiannis	1
VebjornLjosa	ArnabBhattacharya	2
PanagisMagdalinos	MichalisVazirgiannis	1
ZhiZhou	ChongHuang	1
XianPingTao	JunLi	1
ShuichengYan	BenyuZhang	1
HenryTan	ElizabethChang	3
JeffreyBenkler	BingLiu	2
WagnerMeiraJr.	MohammedJaveedZaki	1
RoelVercammen	JanParedaens	1
YufeiTao	JianPei	1
DavidS.Channin	DanielaStanRaicu	1
JohnK.Debenham	DebbieZhang	1
ZhengZhang0002	AlbertoO.Mendelzon	1
VolkerMarkl	StephanEwen	2
MingZhang	DongqingYang	1
Jun'ichiTatemura	ArsanySawires	1
MattWelsh	JeffreyShneidman	1
TomohiroYoshihara	DaiKobayashi	2
WilliamY.Arms	ManuelCalimlim	1
MichaelHerscovici	JohnMcPherson	1
DanielKifer	AshwinMachanavajjhala	1
VanessaP.Braganholo	AlexandreAndrade	1
ThemisPalpanas	GeorgeA.Mihaila	1
HuanLiu	GabrielPuiCheongFung	1
ZhiZhou	YongHongTian	1
NickKoudas	AmitMarathe	1
WilliamY.Arms	JuliaDeneva	1
YangLiu	XiangjiHuang	2
ChandrikaKamath	AbrahamBagherjeiran	1
MichaelReichert	JayantaBasak	1
PeterA.Boncz	JanFlokstra	1
RichardScheines	RicardoSilva	1
JeffreyXuYu	BolinDing	1
VelenLiang	DanielJ.Abadi	1
PhilipS.Yu	PengWang	1
ElkeA.Rundensteiner	BinLiu	1
JaideepSrivastava	AmitBose	1
MoonBaeSong	Chong-SunHwang	1
LisaFong	AmarnathGupta	1
TingLiu	KejunZhu	1
Ki-JouneLi	Jung-RaeHwang	1
ShanWang	BengChinOoi	1
WeiWang0009	JianPei	3
JohnMcPherson	EugeneJ.Shekita	1
PhilipS.Yu	EricBouillet	1
ManLungYiu	DimitrisPapadias	1
PingWu	BenY.Zhao	1
PhilipS.Yu	JiaweiHan	5
TianXia	EvangelosKanoulas	1
ShashiShekhar	JinSoungYoo	2
SusanB.Davidson	StephenFisher	1
ZivBar-Yossef	Yo*lleS.Maarek	1
MingzhuWei	HongSu	1
Wang-PinHsiung	K.Sel*ukCandan	3
TatsuyaMori	KimihiroYamamoto	1
ThomasHofmann	BenediktBrors	1
LiWang	JiZhu	1
PeterKunath	MatthiasRenz	7
NickKoudas	KenQ.Pu	1
OrlandoAvila-Garc*a	A.Est*vezGarc*a	1
JoshuaSpiegel	EmmanuelD.Pontikakis	1
HuaLu	ChristianS.Jensen	1
TaoChen	FrederickH.Lochovsky	1
DuncanG.Bell	BeatrizdelaIglesia	1
ZografoulaVagena	MichailVlachos	1
Wook-ShinHan	HolgerKache	1
SungzoonCho	DongilKim	1
SamuelMadden	AmolDeshpande	1
WenfeiFan	FlorisGeerts	2
RebeccaN.Wright	KrishnanPillaipakkamnatt	1
MohammedJaveedZaki	ChristopherD.Carothers	1
PavelDmitriev	JohannesGehrke	1
YiFang	NealFeierabend	1
WanxiaXie	DavidFisher	1
XiaoMingZhou	SatyaSreenivasan	1
QinfengGuo	HaoChen0005	1
TommyGagnes	EllenMunthe-Kaas	1
NadiaHegazy	DinaA.Said	1
VelenLiang	StavrosHarizopoulos	1
RichardMortier	AustinDonnelly	2
GautamDas	BenjaminArai	1
SusanPaulsen	AndrewB.Nobel	1
RichCaruana	DariaSorokina	1
SongWang	ShoushenYang	1
DivyakantAgrawal	BenY.Zhao	1
VerenaKantere	JohnMylopoulos	1
LouiqaRaschid	BertramLud*scher	1
Wei-YingMa	SouravS.Bhowmick	1
WenxueHuang	JianhongWu	1
Yen-KuangChen	EdwardY.Chang	1
NagaK.Govindaraju	AnastassiaAilamaki	2
RameshNatarajan	RaduSion	1
SusanB.Davidson	StevenBird	1
WesleyM.Hochachka	RichCaruana	1
VictorS.Sheng	CharlesX.Ling	1
MichaelCammert	DimitrisPapadias	1
SusanMalaika	SimonLaws	1
MarcSobel	LonginJanLatecki	1
XuehuaShen	ChengXiangZhai	1
FedjaHadzic	AmandeepS.Sidhu	1
MarieO.Murray	ChangzhouWang	1
YongShi	LinglingZhang	1
Young-KooLee	Woong-KeeLoh	1
HongyiHu	AllenMiu	1
ZhenZhang	KevinChen-ChuanChang	1
JosephM.Hellerstein	AmolDeshpande	2
WilliamY.Arms	JimCordes	1
PradeepTamma	JudeW.Shavlik	1
SuhridBalakrishnan	DavidMadigan	1
WaiTakYim	VincentTo-YeeNg	1
RadaChirkova	FereidoonSadri	1
TamerKahveci	JayendraVenkateswaran	2
StefanoSpaccapietra	OleksandrDrutskyy	1
HuaShi	DaymondLing	1
N.R.Achuthan	AmitRudra	1
ZhengShao	JiaweiHan	3
XiaohuaZhou	XiaodanZhang	3
TakashiKobayashi	RyoTaguchi	2
YixinDiao	ChristianGarcia-Arellano	1
ZhenbangRong	MeiLiu	1
GiorgioCorani	ChrisEdgar	1
XingSun	WeiWang0010	1
Kwok-YanLam	Jia-GuangSun	1
RichardD.SissonJr.	AparnaS.Varde	1
MichaelC.Burl	DominicMazzoni	1
JamesFord	AmitChakrabarti	1
YunboCao	RuiLi	1
ZaiqingNie	JunZhu	1
VagelisHristidis	KenQ.Pu	1
MarkusG.Anderle	DavidM.Steier	1
TimK.Cocx	JoostN.Kok	1
TheoH*rder	MichaelPeterHaustein	2
TianQiu	RichiNayak	1
LipingJi	AnthonyK.H.Tung	1
ShivakumarVaithyanathan	AnHaiDoan	1
WillieNg	ManoranjanDash	2
Kian-LeeTan	JohnShepherd	1
NishantKapoor	GautamDas	1
LeiChen0003	Bee-ChungChen	2
LuhYen	AlainPirotte	1
MarianneWinslett	GianlucaTonti	1
RichardA.O'Keefe	NathanRountree	1
YingXu0002	AndreiZ.Broder	1
XiaohuaZhou	XiaLin	1
ShashiShekhar	JamesP.Rogers	1
BretHull	AllenMiu	1
JimCordes	DanielRiley	1
GuyM.Lohman	C.Mohan	1
VinayakR.Borkar	DanielEngovatov	1
PhilipS.Yu	JianPei	1
ShinAndo	EinoshinSuzuki	1
CuipingLi	BengChinOoi	1
NanJiang	JianweiLi	1
JeffreyT.Kreulen	HakanHacig*m*s	1
KeWang	JasonZhang	1
FranciscoVargasRuiz	A.Est*vezGarc*a	1
TobiasSunder	JuttaA.M*lle	1
RanWolff	ArikFriedman	1
YongZhang	JianyongWang	1
PanagiotisPapapetrou	GeorgeKollios	1
MatthiasBrantner	GuidoMoerkotte	2
ShuichengYan	QiangYang	1
XiaojunChen	GrahamJ.Williams	1
YaoWu	FelixNaumann	1
KenSamuel	JoelKorb	1
TillWestmann	MichaelJ.Carey	2
YiyaoLu	King-LupLiu	1
PeterScheuermann	GoceTrajcevski	2
LiseGetoor	ChabaneDjeraba	2
YiyaoLu	ClementT.Yu	1
NaokiAbe	JohnLangford	1
JianPei	AdaWai-CheeFu	3
MuthuramakrishnanVenkitasubramaniam	JohannesGehrke	2
PaoloPapotti	ArielFuxman	1
JunYan	JilinChen	1
JustinBrickell	InderjitS.Dhillon	1
SuratnaBudalakoti	NeoklisPolyzotis	1
RaymondJ.Mooney	MikhailBilenko	1
YiWang	JianyongWang	1
AndreaPorzel	AlexanderHinneburg	1
RyutaroIchise	HideakiTakeda	1
XiaoweiXu	GalShafirstein	1
YunSingKoh	NathanRountree	1
GerdStumme	ChristophSchmitz	1
JigneshM.Patel	AnandSwaroop	1
RoyGr*nmo	AphroditeTsalgatidou	1
RajasekarKrishnamurthy	EserKandogan	1
MariosHadjieleftheriou	LeonidReyzin	1
YuanShi	BoxuanZhai	1
XiaoguangQi	BrianD.Davison	1
SandeepMane	JaideepSrivastava	2
YongZhang	JianhuaFeng	2
StefanManegold	AnastassiaAilamaki	1
ThomasP.Albright	HaoChen0005	1
O.Garc*a	MartinKnoblauch	1
DavidC.Brown	AparnaS.Varde	1
MarcoZaffalon	IsabelleMarshall	1
S.Sudarshan	GovindKabra	1
CarlosAndr*R.Pinheiro	AlexandreEvsukoff	1
YongYang	DavidFisher	1
YongluanZhou	Kian-LeeTan	1
BouchraBouqata	BoleslawK.Szymanski	2
SujeethThirumalai	KarthikGomadam	1
W.P.Weiss	JamesZeWang	1
JamesRhodes	HakanHacig*m*s	1
YangZhang	AllenMiu	1
QingLi	LeiChen0002	1
SriramRaghavan	ShivakumarVaithyanathan	1
MingxiWu	ChrisJermaine	1
EsperanzaMarcos	EduardoFern*ndez-Medina	1
JureLeskovec	Jos*FernandoRodriguesJr.	1
PabitraMitra	NitinMangal	1
NicholasGerner	FanYang0002	1
SelcukAya	AndersRyd	1
P.S.Sastry	K.P.Unnikrishnan	1
XueLi	DaweiSong	1
Fatma*zcan	AndreyBalmin	1
WeiWang0009	S.H.Boey	1
TsauYoungLin	Jean-DavidHsu	1
ZhouxuanTeng	WenliangDu	1
WeiyiMeng	WanjingZhang	1
UtkarshSrivastava	PeterJ.Haas	1
RafaelPe*aloza	GihanDawelbait	1
MaryF.Fern*ndez	KathleenFisher	1
QiZhong	DawitYimamSeid	1
YuetingZhuang	QingLi	1
ZografoulaVagena	DavidB.Lomet	1
RicardoA.Baeza-Yates	NivioZiviani	2
HuyT.Vo	CarlosEduardoScheidegger	2
GeoffSkinner	ElizabethChang	1
TerryGaasterland	Maria-EstherVidal	1
ChuanXiao	BoNing	1
RobertoTrasarti	FoscaGiannotti	1
DeepakAgarwal	AndrewMcGregor	1
WeiPeng	TaoLi	1
XiuliMa	ShiweiTang	1
ClaudiaPlant	ChristianB*hm	1
YanSong	HongJiangZhang	1
YifengZheng	JunhyongKim	1
Wei-YingMa	QiongLuo	1
JimengSun	DachengTao	1
ThanaaM.Ghanem	AhmedK.Elmagarmid	1
YujiMatsumoto	TakahikoIto	2
TakeshiSuzuki	KaoruMaeda	1
Jo*oPedroPedroso	Jo*oGama	1
NicholasGerner	MirekRiedewald	1
Yuan-ChiChang	MinWang	1
XueruiWang	AndrewMcCallum	1
SunitaSarawagi	DiveshSrivastava	1
WynneHsu	HanyuLi	1
LetiziaTanca	ElisaQuintarelli	1
DeepakLachwani	ChristopherM.Jermaine	1
StephenBay	DavidM.Steier	1
MelanieWeis	FelixNaumann	3
Gy*rgyJ.Simon	EricEilertson	1
GangChen	ChunChen	1
NicolaeConstantinescu	MirelCosulschi	1
DushyanthNarayanan	AntonyI.T.Rowstron	2
ShaorongLiu	PeiyaLiu	2
ValterCrescenzi	PaoloMerialdo	1
RuchaneewanSusomboon	DavidS.Channin	1
MeiLiu	KangXie	1
SujeetBanerjee	SachinThatte	1
YuxiaYao	Ee-PengLim	1
HenriBriand	FabriceGuillet	1
YihaoZhang	WarwickGraco	1
Jo*oGama	GladysCastillo	1
ShuigengZhou	AoyingZhou	2
BenjaminCichy	AshleyDavies	1
VasantHonavar	Dae-KiKang	2
JianliangXu	HaiboHu	1
GiuseppeDiFatta	AlfonsoUrso	1
PanayiotisTsaparas	EvimariaTerzi	2
JianPei	HaixunWang	1
TerenceCritchlow	ShawnBowers	1
YiyuYao	HowardJ.Hamilton	1
NikolayI.Nikolaev	IdaG.Sprinkhuizen-Kuyper	1
SurajitChaudhuri	NileshN.Dalvi	1
RalfSchenkel	GerhardWeikum	1
SrinivasanParthasarathy	KotagiriRamamohanarao	1
ThomasWolf	ThomasHofmann	1
RadaChirkova	MaximKormilitsin	1
JoeXavier	DraganTomic	1
MatthiasRenz	MartinPfeifle	2
TorstenSteinbach	MichaelReichert	1
WangRonggui	PengQingsong	1
JosepSabria	Jes*sCerquides	1
LiWei	EamonnJ.Keogh	5
JoannJ.Ordille	AlonY.Halevy	1
HaruoYokota	DaiKobayashi	3
ElisabethGeorgii	BenediktBrors	1
JenniferWidom	AnishDasSarma	3
PhamDinhTao	LeThiHoaiAn	1
LuQin	JeffreyXuYu	1
JiaweiHan	CharuC.Aggarwal	1
K.Sel*ukCandan	JongWookKim	2
JulianaFreire	EdlenoSilvadeMoura	1
VishalSikka	C.Mohan	1
JianChihOu	Chi-YaoTseng	1
RitendraDatta	JamesZeWang	1
JinboBi	GlennFung	1
CristianBucila	AlexandruNiculescu-Mizil	1
MirekRiedewald	DanielFink	1
MutluMete	Chun-YangFan	1
PhilipS.Yu	GangLuo	1
VoNgocAnh	AlistairMoffat	1
NikosMamoulis	DimitrisPapadias	1
SougataMukherjea	DipanjanChakraborty	1
JihadBoulos	HalaOllaic	1
MirekRiedewald	DanielRiley	1
YuqingWu	SriramMohan	2
KenKonkel	HowardJ.Hamilton	1
LihuaZhao	JenniferHarris	1
MartaMattoso	GeraldoXex*o	1
UlfLeser	FelixNaumann	1
YanchangZhao	ChengqiZhang	1
YiChen	StevenBird	1
LeanderSchietgat	AmandaClare	1
ZhiyongPeng	BoxuanZhai	1
GaoCong	FlorisGeerts	1
JohnJ.Zic	GregoireKraehenbuehl	1
YuanzhenWang	EnhongChen	1
F.Alcojor	A.Viana	1
GlenNewton	BettinaKemme	1
UmeshwarDayal	HarumiA.Kuno	1
JosepSabria	JordiRoig	1
KatsumiKanasaki	HaraldHolz	1
JianjunHao	JiangangZhang	1
PhilipA.Bernstein	ErhardRahm	1
HaixunWang	CarloZaniolo	1
RalfKlinkenberg	IngoMierswa	1
RobertGruber	DavidWalker	1
KitHungCheng	DavidW.Cheung	1
MichalisVazirgiannis	ChristosDoulkeridis	1
JunXu	AbhishekKumar	1
NishithPathak	JaideepSrivastava	1
TerryGaasterland	LouiqaRaschid	1
JohannesGehrke	DavidA.Lifka	1
Yoo-SungKim	Ki-ChangKim	1
RonaldGreeley	NghiaTang	1
JureLeskovec	AgmaJ.M.Traina	1
WeiJiang	MaurizioAtzori	1
WeiWei-Jie	WangBo	1
XingSun	AndrewB.Nobel	1
ShirleyCohen	PatrickHurley	1
XuanZheng	MaryF.Fern*ndez	1
SimonLaws	AmyKrause	1
WilliamW.Cohen	VitorR.Carvalho	1
PredragRadivojac	JamesC.Costello	1
MaryannE.Martone	LisaFong	1
ShuangWu	JieZhou	1
YunmingYe	ShuigengZhou	1
W.ScottSpangler	JamesRhodes	1
YumaoLu	FuchunPeng	1
RaghuRamakrishnan	IonStoica	1
RameshJain	FlorentMasseglia	1
DavidStirling	AliAsheibi	1
MichaelC.Burl	BrianL.Enke	1
TimothyRoscoe	MinosN.Garofalakis	1
Ay*aAzginHintoglu	AlbertLevi	1
ShubhaU.Nabar	RinaPanigrahy	1
JaewooKang	ErginElmacioglu	1
DongXin	ChengXiangZhai	1
Jos*A.Cars*	ArturBoronat	1
LiqiangGeng	KenKonkel	1
SouptikDatta	ChrisGiannella	1
SattarHashemi	MohammadRezaKangavari	1
GuoyangShen	BinGao	1
SrinivasanParthasarathy	MatthewEricOtey	2
MarcelKaram	HalaOllaic	1
ScottSirowy	EamonnJ.Keogh	1
HongyuanZha	HaoyingFu	1
FlorenceSedes	*rickLopez-Ornelas	1
EdlenoSilvadeMoura	AltigranSoaresdaSilva	1
KaraneVieira	JulianaFreire	1
TaneliMielik*inen	HelgerLipmaa	1
RitaP.Ribeiro	Lu*sTorgo	1
ClementT.Yu	AnHaiDoan	1
JamesP.Rogers	JamesA.Shine	1
MalcolmPotts	DeeptKumar	1
EvimariaTerzi	EllaBingham	1
KaiPuolam*ki	HeikkiMannila	1
RobinD.Burke	ChadWilliams	2
S.S*nchez	O.Garc*a	1
WeiHong	JosephM.Hellerstein	1
OrlandoAvila-Garc*a	FranciscoVargasRuiz	1
LarsE.Olson	AndrzejUszok	1
VladimirSoroka	RonnyLempel	1
LeahE.Steinberg	BenjaminJ.Anderson	1
KarthikGomadam	KangLi	1
PatrickHurley	KarlW.Schulz	1
YiannisKanellopoulos	ChristosTjortjis	1
LeGruenwald	JiantingZhang	1
YanminSun	YangWang0007	1
MohammedManiruzzaman	DavidC.Brown	1
RaghuRamakrishnan	JosephM.Hellerstein	1
WynneHsu	JinChen	1
TaichiMuraki	SatoshiKouno	1
SugatoBasu	IanDavidson	1
YanjiangYang	FengBao	1
YongGao	YalingPei	1
Seung-TaekPark	NathanGood	1
WilliamJ.Merline	MichaelC.Burl	1
TsauYoungLin	AlbertSutojo	1
SergeyMelnik	AlanNash	1
SourashisRoy	PrasanRoy	1
VladimirBychkovsky	SamuelMadden	1
SharadMehrotra	DawitYimamSeid	1
PhuChienNguyen	KouzouOhara	1
Ki-HoonLee	Jae-GilLee	1
VolkerMarkl	MarcelKutsch	3
NormanW.Paton	KwanchaiEurviriyanukul	1
MonaWong-Barnum	LiChen	1
YongdaeKim	VipinKumar	1
YingZhu	PaulS.Katz	1
SoujanyaVadapalli	ManishBhide	1
RudiBelotti	MichaelGrossniklaus	1
ShawnBowers	BertramLud*scher	2
ZografoulaVagena	RogerS.Barga	1
ValTannen	AlinDeutsch	1
ZhenLiu	AnandRanganathan	1
ToshiroKubota	MarcosSalganicoff	1
PeterOwotoki	NatasaManojlovic	1
XiangshangLi	WeiFan	1
StratosPapadomanolakis	AnastassiaAilamaki	1
RuiZhang0003	ChristianS.Jensen	1
BrittaSt*rmann	BrigitteMathiak	1
YukioOhsawa	ShinichiGoda	1
JieChen	HongxingHe	3
PhilipS.Yu	BoLong	1
TobiasRiemenschneider	BernhardSeeger	1
JohnShepherd	JialieShen	2
YongHongTian	ChongHuang	1
JuzhenHe	AoyingZhou	1
GalileoNamata	ChristopherP.Diehl	1
ShubhaU.Nabar	JenniferWidom	1
FernandoMour*o	AdrianoM.Pereira	1
WalidG.Aref	AhmedK.Elmagarmid	2
StefanieRinderle	ManfredReichert	1
QiankunZhao	AixinSun	1
DanJiang	ChristophF.Eick	1
ReneSchult	MyraSpiliopoulou	1
BrittaSt*rmann	AndreasKupfer	1
ThimiosDimopulos	ChristosMakris	1
RobertGrossman	ChabaneDjeraba	2
RuiZhang0003	DanLin	1
VivekNigam	MichaelSchroeder	1
YongYu	ShicongMeng	1
OsmarR.Za*ane	JunfengWu	1
GaborMelli	EdmundFreeman	1
PetraKralj	NadaLavrac	1
KeDeng	KaiXu0003	1
SamuelMadden	BretHull	1
YaleiHao	GeraldQuirchmayr	1
Yi-HungWu	MarkCheng-EnnHsieh	1
YapingLi	DmitriAsonov	1
MargheritaBerardi	DonatoMalerba	1
IgnacioGarc*a	F.Alcojor	1
YingjiuLi	LingQiu	1
YutakaHirokawa	AtsushiKobayashi	1
MichaelPantazoglou	AphroditeTsalgatidou	1
TomoeSugihara	ShubhaU.Nabar	1
DavidC.Brown	CarolinaRuiz	1
IndiraMeshram	AnandGupta	1
MohamedFaridElhawary	DanielFink	1
JureLeskovec	ChristosFaloutsos	2
SongLin	DemetriosZeinalipour-Yazti	1
SlawomirStaworko	JanChomicki	2
JunmeiWang	ChangSheng	1
SunitaSarawagi	AmitChandel	1
PeterMork	JoelKorb	1
YifengZheng	StephenFisher	1
Wei-ChuanLiu	Ming-SyanChen	1
DeborahSilver	BingBai	1
JavierGarc*a-Garc*a	CarlosOrdonez	1
LaurentMignet	JayantaBasak	1
WeiWang0009	PhilipS.Yu	1
YiFang	AuroopR.Ganguly	1
LauraM.Haas	DinaBitton	1
Ming-ChienShan	Mal*Castellanos	1
JuhoMuhonen	HannuToivonen	1
YossiMatias	LeonPortman	2
TingshaoZhu	DengyongZhou	1
VinishKathuria	BernardJ.Jansen	1
VasantHonavar	AdrianSilvescu	2
VladimirBychkovsky	HongyiHu	1
SimelaTopouzidou	GeorgeAthanasopoulos	1
HenryTan	FedjaHadzic	3
MarioPiattini	EduardoFern*ndez-Medina	2
MosheFresko	BinyaminRosenfeld	1
LingWang	ElkeA.Rundensteiner	3
TysonCondie	IonStoica	1
MohamedZa*t	DineshDas	1
JohannesGehrke	DariaSorokina	1
XabierLarrucea	GorkaBenguriaElguezabal	1
XuanhuiWang	ShenHuang	1
FangLiu	AbdurChowdhury	1
WeiFan	BillP.Buckles	1
YannisManolopoulos	AthenaVakali	1
SoonYoungJung	MoonBaeSong	1
VincenzoMinei	AntonioAlbano	1
SrinivasanParthasarathy	RaghuMachiraju	1
TengjiaoWang	DongqingYang	1
TongSun	JohnHandley	1
TengjiaoWang	GuojieSong	1
SoonYoungJung	Kwang-SikChung	1
NeoklisPolyzotis	JoshuaSpiegel	2
LinGuo	JayavelShanmugasundaram	1
W.P.Weiss	DhirajJoshi	1
TimosK.Sellis	PawelPlacek	1
HongSu	AndrewWitkowski	1
ZhengyuanZhu	AndrewMcGregor	1
DraganTomic	BrandonBerg	1
TomaszKaczmarek	MarekKowalkiewicz	1
MorHarchol-Balter	ArunIyengar	2
RajP.Gopalan	AmitRudra	1
StefanBrecheisen	MichaelGruber	1
YongwhaChung	HansungLee	1
SibelAdali	MalikMagdon-Ismail	1
IoanaManolescu	EmanuelTaropa	1
KelvinSim	JinyanLi	1
MichelGoraczko	HariBalakrishnan	1
ShanWang	LuQin	1
RonaldGreeley	RebeccaCasta*o	1
SaikatMukherjee	I.V.Ramakrishnan	1
TaroTezuka	ChiTian	1
VebjornLjosa	AmbujK.Singh	3
EricK.Y.Ho	ArnoJ.Knobbe	2
QiaozhuMei	HongCheng	1
ErichM.Nahum	AdamWierman	1
Yiu-KaiNg	XiaochunYang	1
TaoXiong	ChandraKambhamettu	1
JianPei	Byung-WonOn	1
SongWang	MingLi	1
ShyongK.Lam	JohnRiedl	1
YaliZhu	ElkeA.Rundensteiner	1
SteveWedig	OmidMadani	1
XiuliMa	DehuiZhang	1
RunpingQi	NadavEiron	1
YingFeng	DivyakantAgrawal	1
LeThiHoaiAn	LeHoaiMinh	1
LijunChen	HaoChen0005	1
ZhengChen	ShuzhenNong	2
FlorisGeerts	AnastasiosKementsietsidis	3
StefanManegold	JensTeubner	2
DeborahS.Gross	BenjaminJ.Anderson	1
YufeiTao	DonghuiZhang	1
Seung-HwanLim	Sang-WookKim	1
YutakaYanagisawa	TetsujiSatoh	1
RalphKrieger	IraAssent	1
RichardF.Helm	MalcolmPotts	1
MichailVlachos	LiWei	1
NghiaTang	AshleyDavies	1
SongHan	GeoffSkinner	1
VicentePelechano	CarlosCetina	1
OliviuGhica	AnnikaHinze	1
MartaMattoso	BernardoMiranda	1
LizhuZhou	JianhuaFeng	4
SuzanneM.Embury	AlunD.Preece	1
WilliamPerrizo	AijuanDong	1
GeorgeNagy	DinaQ.Goldin	1
Mar*aCruzValiente	GonzaloG*nova	1
TorstenGrust	K.SjoerdMullender	1
SaileshKrishnamurthy	MichaelJ.Franklin	1
WindsorW.Hsu	MarianneWinslett	1
ZhaohuiWu	YiFeng0004	1
PilarParra	DanielMeziat	1
DennisGannon	BethPlale	1
MichaelGrossniklaus	BeatSigner	1
SumitNegi	SachindraJoshi	1
VladimirBychkovsky	MichelGoraczko	1
TakayukiYumoto	KatsumiTanaka	1
SunilChoenni	ErikLeertouwer	1
JonathanC.Yang	AriD.Brooks	1
Seo-YoungKim	Ki-HoonLee	1
PhilipZigoris	DamianEads	1
ZengjianHu	MartinEster	1
WeiWang0009	JiahengLu	1
YoungheeLee	In-YoungKo	1
R*merRosales	GlennFung	1
DipanjanChakraborty	AmitAnilNanavati	1
MoonBaeSong	Kwang-SikChung	1
MuthuramakrishnanVenkitasubramaniam	DanielKifer	1
YannisTheodoridis	SpyrosVosinakis	1
PlamenP.Angelov	FrankKlawonn	1
KuiyuChang	BinShi	1
PeterKunath	ChristianB*hm	2
YasutoshiYajima	Tien-FangKuo	1
HongSu	AllisonW.Lee	1
XiangdongZhou	JianPei	1
XinZhou	CarloZaniolo	2
PaulJ.Kennedy	AhmadAl-Oqaily	1
NaveenAshish	NaliniVenkatasubramanian	1
DongwonLee	AngelaBonifati	1
SujuRajan	KunalPunera	1
JohannesGehrke	GregoryJ.Sharp	1
VincentC.S.Lee	KateSmith-Miles	1
TysonCondie	MinosN.Garofalakis	1
MichaelH.B*hlen	KlausR.Dittrich	1
LarsBackstrom	DanielP.Huttenlocher	1
Ming-HaoHung	Jun-WunJou	1
Ming-TingSun	BelleL.Tseng	1
MonaWong-Barnum	AmarnathGupta	1
M.Glittum	GeorgeAthanasopoulos	1
See-KiongNg	Mong-LiLee	1
DongXin	ChenChen	1
XiaoyunHui	ChuanXiao	1
GaoCong	AnastasiosKementsietsidis	1
JunXu	ErranL.Li	1
VikramChandramohan	TuanD.Pham	1
ElkeAchtert	AlexeyPryakhin	3
SangeetaDoraiswamy	HetalThakkar	1
LeiZhang0001	KefengDeng	1
SiegfriedNijssen	Bj*rnBringmann	1
YingLiu	XingsenLi	1
MarkJunjieLi	JoshuaZhexueHuang	1
WeizhenChen	QileChen	1
MageshJayapandian	H.V.Jagadish	1
RafaelPe*aloza	MichaelSchroeder	1
DivyakantAgrawal	CaijieZhang	1
KevinWilkinson	HarumiA.Kuno	1
CarlosA.Hurtado	ArielCid	1
WaiTakYim	StephenChi-faiChan	1
Shinn-YingHo	Shinn-JangHo	2
WenxueHuang	LiminLin	1
Ya-TiPeng	Ming-TingSun	1
GerhardWeikum	GeorgianaIfrim	2
VishalSikka	HonestyC.Young	1
Shu-ChingChen	Mei-LingShyu	1
NieYu	LingpengYang	1
FlorinRusu	AlinDobra	1
PeterTriantafillou	ChristianZimmer	1
ChristophSturm	AbrahamBernstein	2
Kwok-YanLam	JianminWang	1
RuiZhang0003	NickKoudas	1
VijayshankarRaman	JosephM.Hellerstein	1
TimothyRoscoe	PetrosManiatis	1
JingJin	Gail-JoonAhn	1
TorstenSteinbach	PrasanRoy	1
RitendraDatta	DhirajJoshi	1
ZifangHuang	ShichaoZhang	1
PakChungSham	MarkJunjieLi	1
HugoZaragoza	ChrisBurges	1
Arne-J*rgenBerre	AphroditeTsalgatidou	1
SougataMukherjea	GautamDas	1
ShaileshJoshi	RichardT.Snodgrass	1
RongGe	ByronJ.Gao	1
KevinChen-ChuanChang	IhabF.Ilyas	1
JihuaHuang	JiangangZhang	1
StephenC.North	ChrisVolinsky	1
MarcelKarnstedt	ManfredHauswirth	1
ManuelCalimlim	DavidA.Lifka	1
JohnZimmerman	IsaacSimmons	1
ChingChang	AzerBestavros	1
SureshVenkatasubramanian	DeepakAgarwal	1
RizosSakellariou	NormanW.Paton	1
RaffaelePerego	FoscaGiannotti	1
LawrenceH.Reeve	AriD.Brooks	1
LilianaCalder*n-Benavides	DavidF.Nettleton	1
LucasScharenbroich	BrianL.Enke	1
KeiYuasa	KannanGovindarajan	1
J*rgLange	ErhardRahm	1
OmarBoucelma	BarbaraCatania	1
JulioC.L*pez	AnastassiaAilamaki	1
UlfLeser	HeikoM*ller	1
WeiyiMeng	King-LupLiu	1
WolfgangJank	GalitShmueli	1
StevenP.Callahan	CarlosEduardoScheidegger	2
SunitaSarawagi	P.C.Nagesh	1
Seung-TaekPark	DavidPennock	1
PeterTriantafillou	GerhardWeikum	3
JanO.Pedersen	EmreVelipasaoglu	1
LauraIrinaRusu	DavidTaniar	1
NicolaOnose	MichaelJ.Carey	1
WilliamZhu	Fei-YueWang	1
SrihariPadmanabhan	RamanathanBalachandran	1
NickKoudas	ChenLi	1
FushengWang	CarloZaniolo	1
MarcosMen*rguezTortosa	Jes*sGarc*aMolina	1
FeifeiLi	ChingChang	1
RakeshAgrawal	DmitriAsonov	1
YossiMatias	YarivMatia	1
YueXu	WanzhongYang	1
FengYan	Chih-FangWang	1
RaghuRamakrishnan	PhilipA.Bernstein	1
NitinMangal	NitinGupta	1
JanStruyf	HendrikBlockeel	1
YingyiBu	XianPingTao	1
LingWu	DongqingYang	1
MohamedZa*t	HongSu	1
OliviuGhica	Agn*sVoisard	1
Shinn-JangHo	Jun-WunJou	1
SureshVenkatasubramanian	JeffM.Phillips	1
MaryannE.Martone	AmarnathGupta	1
YefeiPeng	DaqingHe	1
JosephM.Hellerstein	IonStoica	1
KeWang	JiuyongLi	1
WeiWang0010	AnthonyK.H.Tung	2
NuweeWiwatwattana	H.V.Jagadish	1
Jau-MinWong	I-JenChiang	1
YannisManolopoulos	ApostolosPapadopoulos	1
MinoruKanehisa	HiroshiMamitsuka	1
MircoNanni	DinoPedreschi	1
XibeiJia	WenfeiFan	1
RinaPanigrahy	RaviKumar	1
RobertC.Holte	Maria-LuizaAntonie	1
ZhengChen	ShenHuang	1
MohammedJ.Zaki	AdrianoVeloso	1
TomoeSugihara	AnishDasSarma	1
JunoChang	Hyeon-JoongYoo	1
OsmarR.Za*ane	BrendanKitts	1
Mong-LiLee	HanyuLi	1
Orhan*amoglu	JayendraVenkateswaran	1
TomoeSugihara	JenniferWidom	1
StratosIdreos	ManolisKoubarakis	1
YoshinariKanamori	MasayoshiAritsugi	1
SpyrosPassas	PanosVassiliadis	1
Hua-FuLi	Chin-ChuanHo	2
DanielMoss*	AlexandrosLabrinidis	1
FedericaMandreoli	EnricoRonchetti	2
XiaoyanZhu	FengJing	1
PrasanRoy	MukeshK.Mohania	1
VictorMunt*s-Mulero	Josep-LluisLarriba-Pey	1
XueyanTang	JianliangXu	1
CheeYongChan	AnthonyK.H.Tung	2
YingLiu	JianhongZhou	1
DennisDeCoste	BrianL.Enke	1
PeterA.Boncz	JanRittinger	2
DimitrisPapadias	BernhardSeeger	1
PeerKr*ger	ChristianB*hm	5
GuojieSong	DongqingYang	1
SamuelMadden	MiguelFerreira	1
Kian-LeeTan	JialieShen	1
ZonghongZhang	YingxinLi	1
YiLu	AdrianE.Platts	1
RunaBhaumik	RobinD.Burke	2
YingChen	ToddEavis	1
OuriWolfson	BoXu	1
AssafSchuster	ArikFriedman	1
Thanh-NghiDo	Fran*oisPoulet	1
ToddC.Mowry	AnthonyTomasic	1
Yi-TingLai	HuaShi	1
Jun'ichiTatemura	AmrElAbbadi	1
DiegoMilano	AnastasiosKementsietsidis	2
NataliaMarquez	MarelisCardenas	1
OsmarR.Za*ane	HongqinFan	1
PaulBarford	Bee-ChungChen	2
ShicongMeng	DingyiHan	1
XinqiangZuo	Jia-GuangSun	1
RamayyaKrishnan	NachiketaSahoo	1
ThomasDoggett	NghiaTang	1
ShichaoZhang	ChengqiZhang	2
PedroCoutinho	FranciscoM.Couto	1
ArunIyengar	AdamWierman	1
VickyNassis	RajuganRajagopalapillai	1
Ji-RongWen	FeiWu	1
ShigeoSugimoto	Ken'ichiIshikawa	1
ZhengShao	DongXin	3
SujeetBanerjee	KanadDixit	1
Suh-YinLee	Hua-FuLi	2
HuiXiong	EricEilertson	1
WagnerMeiraJr.	AdrianoM.Pereira	1
ManoliAlbert	JavierMu*oz	1
PaulJ.Fortier	HowardE.Michel	1
Zo*Lacroix	Herv*M*nager	1
TakashiWashio	KouzouOhara	1
YangLiu	AijunAn	2
NeriusTradisauskas	ChristianS.Jensen	1
RajeevRastogi	MeichunHsu	1
YaleiHao	MarkusStumptner	1
JavierJ.Guti*rrez	AntoniaM.ReinaQuintero	1
MarioAntonioletti	AndrewEisenberg	1
RangaRajuVatsavai	JayantaBasak	1
XueminLin	KaiXu0003	1
YukioOhsawa	KiichiIto	1
SandrodaSilvaCamargo	PauloMartinsEngel	1
RaresVernica	ChenLi	1
M*rioJ.Silva	FranciscoM.Couto	1
BengChinOoi	AnthonyK.H.Tung	2
StephenRobertson	HugoZaragoza	1
HuanHuo	GuorenWang	1
KanishkaBhaduri	HillolKargupta	2
XianPingTao	ShaxunChen	1
JanPrins	AndrewB.Nobel	1
ShubhaU.Nabar	MarcusFontoura	1
TysonCondie	JosephM.Hellerstein	1
Kwang-SikChung	Ki-SikKong	1
YingyiBu	JianLu	1
GiuseppeM.Mazzeo	FilippoFurfaro	1
E.Sithirasenan	D.Green	1
ThomasJ.E.Schwarz	PeterTsui	1
MauricevanKeulen	JanFlokstra	1
MargoI.Seltzer	JonathanLedlie	1
ShipengYu	MingruiWu	1
KevinWilkinson	KannanGovindarajan	1
SongyunDuan	ShivnathBabu	1
MarceloMendoza	CarlosA.Hurtado	1
TaoLi	HaesunPark	1
HuahaiHe	AmbujK.Singh	2
SelcukAya	JohannesGehrke	1
RemaPadman	NachiketaSahoo	1
PhilipA.Bernstein	HongfeiGuo	1
XiaojingYuan	WeiDing0003	1
QiangYang	Jian-TaoSun	3
TomotakeNakamura	NoriyoshiYoshida	1
ShyamK.Gupta	AnandGupta	1
PeterBuneman	AnastasiosKementsietsidis	1
XiaomingJin	JianminWang	1
MarcosR.Vieira	AdrianoS.Arantes	1
RaviKumar	JasmineNovak	1
OmarBenjelloun	AnishDasSarma	3
KyojiKawagoe	GuifangDuan	1
YannisTheodoridis	NikosPelekis	1
ToshiroKubota	GlennFung	1
SergioFlesca	BettinaFazzinga	1
Jo*oM.B.Cavalcanti	EdlenoSilvadeMoura	1
ShuZhang	MarkusHagenbuchner	1
MassimilianoAlbanese	AntonioPicariello	1
VivekanandGopalkrishnan	JinyanLi	1
DimitriosKatsaros	AthenaVakali	1
UmeshwarDayal	Ming-ChienShan	1
OlfaNasraoui	FabioA.Gonz*lez	1
SandeepTata	AnandSwaroop	1
SibelAdali	BoleslawK.Szymanski	1
Zhi-QiangLiu	JianyongWang	1
VassiliosS.Verykios	GeorgeV.Moustakides	1
PrasannaPadmanabhan	LeGruenwald	2
FranciscoVargasRuiz	E.VictorS*nchezRebull	1
NikosNtarmos	ChristianZimmer	1
ShaxunChen	JunLi	1
WenshengWu	AnHaiDoan	1
VasantHonavar	FlavianVasile	1
VasantHonavar	FacundoBromberg	1
YuanShi	XiangZhou	1
ZhengyuanZhu	JeffM.Phillips	1
XiaoxinYin	PhilipS.Yu	1
PhuongNguyen	HillolKargupta	1
VenkateshGanti	JiaweiHan	1
ZeeshanSardar	BettinaKemme	1
FrankS.Spear	AdamMarcus0002	1
HaoyingFu	GordonSun	1
MitchCherniack	EstherRyvkina	1
MichaelWurst	IngoMierswa	1
GeraldMadlmayr	FushengWang	1
SrinivasanParthasarathy	SitaramAsur	1
DennisDeCoste	DavidPennock	1
GianlucaTonti	AndrzejUszok	1
TimosK.Sellis	KostasPatroumpas	2
SourashisRoy	ManishBhide	1
HetalThakkar	HaixunWang	1
SrinivasanParthasarathy	S.Srinivasan	1
ZacharyEyler-Walker	DaveDeBarr	1
HuajunChen	HengWang	1
ShirishKrishnajShevade	M.NarasimhaMurty	1
VishalSikka	SangKyunCha	1
SoonYoungJung	KwangJinPark	1
MirkoSteinle	ChristianLovis	1
SatyanarayanaR.Valluri	LiniT.Thomas	1
StephanBloehdorn	MarcoCammisa	1
AlessandroRaffio	AlessandroCampi	1
IlyaVladimirskiy	EvangelosDellis	1
NobuhisaUeda	KiyokoF.Aoki-Kinoshita	1
Jos*FernandoRodriguesJr.	ChristosFaloutsos	1
WenfeiFan	PeterBuneman	1
MiguelRomero	JuandeLara	1
MichaelGibas	HakanFerhatosmanoglu	1
JianXu	JianPei	2
LarryPryor	DennisMcLeod	1
KeithWesnes	IsabelleMarshall	1
NathanielMartin	EamonnJ.Keogh	1
XinChen	ChenWang	1
MohammedJaveedZaki	MarcoCristo	1
EibeFrank	BernhardPfahringer	1
LeChen	KefengDeng	1
ZhengChen	HuaLi	1
AntoninoFiannaca	AlfonsoUrso	1
SpyrosPassas	ManolisTerrovitis	1
RobertoPerdisci	GuofeiGu	1
GuidoMoerkotte	Carl-ChristianKanne	3
LeiZou	HuamingZhang	1
LeonardJ.Seligman	JoelKorb	1
RiccardoTorlone	LucaCabibbo	1
NingZhang0002	IhabF.Ilyas	2
ShiweiTang	MingZhang	1
MirelCosulschi	GeorgeStephanides	1
TiejunHuang	ChongHuang	1
TuBaoHo	Minh-HoangLe	1
ShuzhenNong	NingLiu	2
HanghangTong	ChristosFaloutsos	3
YiFang	VeeraraghavanVijayaraj	1
MihoOhsaki	HidetoYokoi	1
DanLin	ChristianS.Jensen	1
MichaelW.Mahoney	MauroMaggioni	1
GeneCooperman	DonghuiZhang	1
ThemisPalpanas	DimitriosGunopulos	1
XiaopengXi	ScottSirowy	1
VenkateshGanti	ArvindArasu	1
VladislavShkapenyuk	AnastassiaAilamaki	1
KoustuvDasgupta	DipanjanChakraborty	1
GregoireKraehenbuehl	FredericJaccard	1
O.Garc*a	DanielMeziat	1
TakashiKobayashi	DaiKobayashi	2
PrasanRoy	JayantaBasak	1
MarieO.Murray	AnneHunt	1
ManishBhide	JayantaBasak	1
YangZhang	HariBalakrishnan	1
JamesM.Kang	EricD.Kolaczyk	1
ChristianPlattner	AndreasWapf	1
XiaohuaHu	XiaodanZhang	4
HuidongJin	GrahamJ.Williams	1
ZhihuaZhang	EdwardY.Chang	1
MohamedF.Mokbel	GermanShegalov	1
QiLi	ChandraKambhamettu	1
GeYu	BinWang	1
ShiwoongKim	PaeaLePendu	1
ToddEavis	FrankK.H.A.Dehne	1
ZhiyongPeng	XiangZhou	1
XiaolingWang	AoyingZhou	1
MartinKnoblauch	A.Viana	1
RonnyLempel	MarcusFontoura	1
RobertC.Holte	OsmarR.Za*ane	1
QiongHuang	JiyingWang	1
VenkateshGanti	SurajitChaudhuri	1
XuanZheng	RobertGruber	1
JohnYen	BingjunSun	1
IlyaVladimirskiy	AkriviVlachou	1
KorinnaBade	EykeH*llermeier	1
NanTang	Kam-FaiWong	1
PeterTi*o	HuanhuanChen	1
JiuyongLi	AdaWai-CheeFu	1
SenQin	GuanzhongDai	1
VeeraraghavanVijayaraj	AuroopR.Ganguly	1
KiyoshiKogure	AkinoriAbe	1
VanessaP.Braganholo	MartaMattoso	1
MichaelKifer	AndreaCal*	1
ZhaohuiPeng	ShengWang	1
Jen-JouHung	Andr*Seifert	1
ThomasSchwentick	FrankNeven	1
PanosK.Chrysanthis	AlexandrosLabrinidis	1
ToddEavis	AndrewRau-Chaplin	1
JohnR.Kender	HassanH.Malik	1
ShoushenYang	MingzhuWei	1
Yi-ChengTu	SongLiu	1
KameshMunagala	AdamSilberstein	2
WeiPeng	HaesunPark	1
StevenP.Callahan	EmanueleSantos	2
SriramRaghavan	HuaiyuZhu	1
WillemJonker	MauricevanKeulen	2
VibhutiS.Sengar	TorstenSteinbach	1
SimelaTopouzidou	AphroditeTsalgatidou	1
VinishKathuria	AmandaSpink	1
MuthiahChettiar	FanYang0002	1
E.VictorS*nchezRebull	A.Est*vezGarc*a	1
YoungChulPark	JeHyunCho	1
Ren*eJ.Miller	MauricioA.Hern*ndez	1
SusanMalaika	NormanW.Paton	1
LucianPopa	ArielFuxman	1
WeifengSu	JiyingWang	3
UlfLeser	JanaBauckmann	1
WenJin	AnthonyK.H.Tung	2
MuratCanGaniz	MooiChooChuah	1
ZengyouHe	ShengchunDeng	1
ManishParashar	BertramLud*scher	1
Jia-YuPan	Andr*G.R.Balan	1
Wei-YingMa	PingWu	1
MohammedJaveedZaki	ChabaneDjeraba	2
R.MarkGreenwood	PaoloMissier	1
ShengMa	FeiWang	1
MichelSimonet	LamisHawarah	1
ValentinKuznetsov	JimCordes	1
ZhaohuiZheng	HaoyingFu	1
MatthiasRenz	JohannesA*falg	3
PaulB.Kantor	NicuD.Cornea	1
RaghuRamakrishnan	DouglasBurdick	1
TanyaY.Berger-Wolf	JaredSaia	1
LingFeng	HenryTan	1
MehmetM.Dalkilic	JamesC.Costello	1
ZhihaiWang	YanchangZhao	1
XingXie	QiongLuo	1
IreneKotsia	BenoitM.Macq	1
YingjiuLi	SongtaoGuo	2
XiaojunChen	XiaofeiXu	1
Seo-YoungKim	EuijongWhang	1
PavanK.Chowdary	A.Kumaran	1
TakayukiTamura	KulwadeeSomboonviwat	1
WalkerM.White	JohannesGehrke	1
VishalKapoor	PascalPoncelet	1
NormanW.Paton	AmyKrause	1
DanieleBraga	AlessandroCampi	2
PanagiotisSymeonidis	AlexandrosNanopoulos	1
TimosK.Sellis	TheodoreDalamagas	2
YitzhakMandelbaum	DavidWalker	1
PiyushShivam	JeffreyS.Chase	1
Tie-YanLiu	ShijiSong	1
PhilippeSelo	ChitraVenkatramani	1
ZengjianHu	BoazBen-Moshe	1
JohnHandley	EamonnJ.Keogh	1
FathiH.Saad	DuncanG.Bell	1
YingZhu	HaoTian	1
VanaKalogeraki	GautamDas	1
TianchengLi	NinghuiLi	1
XiaochunYang	BinWang	1
SelcukAya	LawrenceGibbons	1
MarcosAndr*Gon*alves	MarcoCristo	1
YasushiSakurai	YasuhiroFujiwara	1
TakashiOnoda	NorihikoIto	1
MargheritaBerardi	CorradoLoglisci	1
ThierryCruanes	RafiAhmed	1
WilliamJ.Merline	BrianL.Enke	1
IsaacSimmons	AnthonyTomasic	1
PascualQueralt	Jos*A.Cars*	1
NamNguyen	CaseySmith	1
SimeonWarner	DariaSorokina	1
EsperanzaMarcos	Bel*nVela	2
J*r*meSim*on	GiorgioGhelli	1
LamisHawarah	AnaSimonet	1
YanchangZhao	LianweiZhao	1
XinZhang	DennisShasha	1
LiniT.Thomas	KamalakarKarlapalem	1
NelsonF.F.Ebecken	AlexandreEvsukoff	1
JohnPearson	FushengWang	1
RogerS.Barga	GermanShegalov	1
KhuzaimaDaudjee	KennethSalem	2
XiaoqianJiang	HwanjoYu	1
TimosK.Sellis	StefanosSouldatos	1
HeikkiMannila	HannesHeikinheimo	1
ThierryCruanes	AllisonW.Lee	1
ErikMeijer	BrianBeckman	1
NormanW.Paton	AlvaroA.A.Fernandes	2
MatthiasNicola	Fatma*zcan	1
RaviJanardan	QiLi	1
YannisPapakonstantinou	HeasooHwang	1
SunitaSarawagi	RahulGupta	1
Ping-JerYeh	Jie-TsungLi	1
MuralidharKrishnaprasad	DieterGawlick	1
VeliBicer	AsumanDogac	1
MingshengHong	AlanJ.Demers	1
Hyeon-JoongYoo	HungKookPark	1
PatrickZiegler	ChristophKiefer	2
Jean-LucHainaut	FabriceEstievenart	1
FathiH.Saad	BeatrizdelaIglesia	1
HyoilHan	AriD.Brooks	1
ZheweiJiang	Wen-ChiHou	2
ErichM.Nahum	ArunIyengar	2
ThomasG.Smith	BenjaminJ.Anderson	1
ShamkantB.Navathe	DavidFisher	1
MichaelReichert	LaurentMignet	1
YongShi	AihuaLi	2
MichaelCammert	ChristophHeinz	1
MirekRiedewald	DavidA.Lifka	1
PavelDmitriev	AndersRyd	1
JingranDai	AihuaLi	1
TommyGagnes	ThomasPlagemann	1
JanRittinger	JanFlokstra	1
YanlingLi	GuanzhongDai	1
Tyng-RueyChuang	Hahn-MingLee	1
Xue-MeiNing	Xiang-SunZhang	1
SabahCurrim	FaizCurrim	1
GabrielaRuberg	FernandaAraujoBai*o	1
RainerSchmidt	KlemensB*hm	1
JimSmith	AnastasiosGounaris	1
O.Rodr*guez	IgnacioGarc*a	1
MukeshSinghal	JingJin	1
TomArmstrong	JoeCatalano	1
MingzhuWei	ElkeA.Rundensteiner	2
VanjaJosifovski	AndrewTomkins	1
LingQiu	Kok-LeongOng	1
FurenXiao	Chun-ChihLiao	1
ZhaohuiWu	XiaoqingZheng	1
YaokaiFeng	AkifumiMakinouchi	1
MichaelI.Dekhtyar	IonutEmilIacob	1
ReynoldCheng	KevinY.Yip	1
KeisukeIshibashi	AtsushiKobayashi	1
StefanWrobel	ChristineK*rner	1
Chun-HaoChen	Chien-HsiangChen	1
VipinKumar	EricEilertson	1
ErichM.Nahum	BiancaSchroeder	2
ValeriaDeAntonellis	MicheleMelchiori	1
HongCheng	DongXin	3
VinodYegneswaran	PaulBarford	2
W.ScottSpangler	HakanHacig*m*s	1
VijayshankarRaman	HolgerKache	2
WeipingWang0001	KimutaiKimeli	1
SunmeeKang	HanseokKo	1
SeydaErtekin	JianHuang0002	1
RaviKumar	AndreiZ.Broder	1
Tie-YanLiu	BinGao	2
RobertJ*schke	GerdStumme	1
J*rgenKr*mer	AlexanderZeiss	1
RusselJ.Stonier	DeepaniB.Guruge	1
RuiZhou	HuanHuo	1
ShashiShekhar	SanghoKim	1
SiuManLui	LingQiu	1
In-YoungKo	DongmanLee	1
JanVandenBussche	EvelineHoekx	1
PeerKr*ger	Hans-PeterKriegel	5
PauloMartinsEngel	BartKuijpers	1
PhuongNguyen	KamalikaDas	1
KekeChen	HuaYan	1
ChristophSchmitz	AndreasHotho	1
MartinTheobald	GerhardWeikum	1
BinCao	AntonioBadia	1
ZhengChen	XuanhuiWang	1
MingruiWu	Hans-PeterKriegel	1
TuBaoHo	LeSyVinh	1
Seung-CheonBaek	Hyun-SookLee	1
WeihongWang	JamesFord	1
XiaofengZhu	ShichaoZhang	1
MichaelCammert	MaximSchwarzkopf	1
W.P.Weiss	RitendraDatta	1
KosukeHashimoto	KiyokoF.Aoki-Kinoshita	1
StefanWrobel	JanRamon	1
RobertM.Bell	PatrickHaffner	1
QiaozhuMei	ChengXiangZhai	2
TimosK.Sellis	MichalisPotamias	1
JimCordes	AndersRyd	1
HenriqueAndrade	ChitraVenkatramani	1
NicoLavarini	CarloCombi	1
TingLiu	AndrewW.Moore	1
LarryPryor	HyunWoongShin	1
TanApaydin	GuadalupeCanahuate	1
Wen-SyanLi	MahadevanSubramanian	1
XinXu	AnthonyK.H.Tung	1
ThomasP.Albright	LijunChen	1
PedroPereiraRodrigues	Jo*oGama	1
ShivakumarVaithyanathan	RaghuRamakrishnan	2
SujeetBanerjee	MichaelJ.Carey	1
TaoXiong	JinboBi	1
YingZhang	WeiWang0011	1
YoussefKadri	Jian-YunNie	1
TiffanyDohzen	JoachimHammer	1
XiaodanZhang	HyoilHan	1
RaresVernica	AnthonyK.H.Tung	1
SoonYoungJung	Chong-SunHwang	1
YuSuzuki	KyojiKawagoe	2
XiaofangZhou	KaiXu0003	1
XiangJi	DingZhou	1
Pu-JenCheng	Lee-FengChien	1
MatthewJ.Rattigan	DavidJensen	1
NiallM.Adams	DavidJ.Hand	1
VanaKalogeraki	DimitrisPapadopoulos	1
XiaopengXi	MichailVlachos	1
IlvioBruder	AmmarBalouch	1
XifengYan	HongCheng	1
HaojunWang	Chi-NgaiWan	1
ValentinKuznetsov	GregoryJ.Sharp	1
RyoTaguchi	DaiKobayashi	3
XingXie	XiangyeXiao	1
JayavelShanmugasundaram	AnandBhaskar	1
DavidR.O'Hallaron	AnastassiaAilamaki	1
EricP.Xing	ChristosFaloutsos	1
PilarParra	F.Alcojor	1
RiccardoRosati	DomenicoLembo	1
SalvatoreGaglio	AlfonsoUrso	1
MihaiGabroveanu	GeorgeStephanides	1
KimNguyen	GiuseppeCastagna	1
StefanSeltzsam	DanielGmach	1
LucianPopa	C.T.HowardHo	1
VikasC.Raykar	RamaniDuraiswami	1
AnastassiaAilamaki	AmitManjhi	1
JunyiXie	JunYang0001	2
JosephM.Hellerstein	DavidChu	2
LingFeng	FedjaHadzic	1
Mal*Castellanos	FabioCasati	1
LingpengYang	Dong-HongJi	1
JiangangZhang	HuipingLi	1
TakeshiSuzuki	AndreasDengel	1
YangSong	HongyuanZha	1
XifengYan	DongXin	1
LeanYu	KinKeungLai	1
WeiHong	JenniferWidom	1
PhilippeBouch*	MarcLeGoc	1
ZengjianHu	ByronJ.Gao	1
BartGoethals	AdrianaPrado	1
HiroshiMotoda	AkiraMogi	1
RolandH.C.Yap	KennyQiliZhu	1
MadhavV.Marathe	ChrisBailey-Kellogg	1
RiccoRakotomalala	Fran*oisPellegrino	1
ErkaySavas	Ay*aAzginHintoglu	1
QiZhang	JinzeLiu	1
WeiWang0010	JinzeLiu	2
RameshJain	PilhoKim	1
SucharitaGopal	JamesM.Kang	1
EduardH.Hovy	DennisMcLeod	1
WaiGenYee	ShamkantB.Navathe	1
PeterMork	ArnonRosenthal	1
LetiziaTanca	CarloCurino	1
YimingMa	SharadMehrotra	2
MirekRiedewald	AlanJ.Demers	2
NingYu	DanzhouLiu	2
StephenRobertson	MichaelJ.Taylor	1
SoujanyaVadapalli	SatyanarayanaR.Valluri	1
PeerKr*ger	JohannesA*falg	3
FernandaAraujoBai*o	AlexandreAndrade	1
MelanieHilario	AdamWoznica	2
ShichaoZhang	FengChen	1
GerdHeber	AnastassiaAilamaki	1
RolandH.C.Yap	JoxanJaffar	1
MondherMaddouri	FatmaKaabi	1
NikolausAugsten	MichaelH.B*hlen	1
PeterScheuermann	Agn*sVoisard	1
Ugur*etintemel	JohnJannotti	3
UweRadetzki	ArminB.Cremers	1
XiaofeiXu	GrahamJ.Williams	1
BinlingJin	AlunD.Preece	1
TheodoreDalamagas	EleniG.Christodoulou	1
K.Sel*ukCandan	AmrElAbbadi	1
YuFujimoto	NoboruMurata	1
GaoCong	BinCui	1
StanleyB.Zdonik	NesimeTatbul	2
MeichunHsu	HonestyC.Young	1
Wei-ShinnKu	RogerZimmermann	2
ThomasLegler	AndrewRoss	1
PilarParra	O.Rodr*guez	1
PanagiotisG.Ipeirotis	EugeneAgichtein	1
Wang-ChienLee	KenC.K.Lee	4
WeiningQian	ShoukeQin	1
MohamedFaridElhawary	DariaSorokina	1
LeiZhang	JulienEtienne	1
GlenNewton	DoinaPrecup	1
KevinChen	EugeneShih	1
XinYao	PingSun	1
IgnacioGarc*a	A.Viana	1
TheodoreDalamagas	DimitriTheodoratos	1
MarcelaGenero	CoralCalero	1
YannisTheodoridis	IlyaVladimirskiy	1
PhilipS.Yu	MariosHadjieleftheriou	1
RimmaV.Nehme	ElkeA.Rundensteiner	1
Sang-HyukLim	Kyong-IKu	1
XiaoyanLi	JinxiangDong	1
SteveKelling	ArtMunson	1
YimingMa	NaveenAshish	1
ShiwoongKim	PeishenQi	1
YingLiu	AlokN.Choudhary	1
FedjaHadzic	ElizabethChang	3
WeiningQian	AoyingZhou	4
SaraCohen	ItzhakFadida	1
HungKookPark	ByounghoSong	1
RaghuRamakrishnan	DavidJ.DeWitt	2
ZivBar-Yossef	IdoGuy	1
SimeonJ.Simoff	LeiZhang	1
TorstenGrust	JanFlokstra	1
Yen-LiangChen	Ping-YuHsu	1
ThorstenVitt	LukasFaulstich	1
NiteshV.Chawla	AlecPawling	1
MichaelPantazoglou	M.Glittum	1
PatrickZiegler	KlausR.Dittrich	3
KwangminChoi	AmitSaple	1
RainerGemulla	AnjaKlein0001	1
TysonCondie	TimothyRoscoe	1
Seok-WonSeong	MujdePamuk	1
JohannesGehrke	AshwinMachanavajjhala	2
LidanShou	GangChen	1
VikramChandramohan	StephenT.C.Wong	1
ShenodaGuirguis	NagwaM.El-Makky	1
YingLi	ShuzhenNong	2
NivioZiviani	ArturZiviani	1
YingFeng	BenY.Zhao	1
YiPeng	GangKou	3
S.H.Boey	BaileShi	1
YannisTheodoridis	IreneNtoutsi	1
PaulWatson	JimSmith	1
PhamDinhTao	LeHoaiMinh	1
XueminLin	PhilipS.Yu	1
ZhengChen	Jian-TaoSun	4
RichardT.Snodgrass	CurtisE.Dyreson	1
RemaPadman	RamayyaKrishnan	1
KangRyoungPark	HungKookPark	1
ShenHuang	Hua-JunZeng	1
KevinY.Yip	DavidW.Cheung	1
KlemensB*hm	BodoVogt	1
ShanWang	CuipingLi	1
JianjunHao	HuipingLi	1
RemaPadman	GeorgeT.Duncan	1
VanessaP.Braganholo	Andr*PriscoVargas	1
KunLiu	KanishkaBhaduri	1
ShashiShekhar	JamesM.Kang	1
ShuguangZhao	LichengJiao	1
YingLiu	AshfaqA.Khokhar	1
GeraldMadlmayr	FredAzar	1
SubhasriDuttagupta	KrithiRamamritham	1
JiuyongLi	HongHu	1
S*ndorH*man	MarcinZukowski	1
CarloCombi	BarbaraOliboni	2
WagnerMeiraJr.	MarcoCristo	1
LouisLicamele	IndrajitBhattacharya	1
ReneSchult	IreneNtoutsi	1
DanielFink	ArtMunson	1
StefanosSouldatos	PawelPlacek	1
ThomasB.Hodel-Widmer	KlausR.Dittrich	1
JuliaDeneva	GregoryJ.Sharp	1
MarceloMendoza	ArielCid	1
JimSmith	AlvaroA.A.Fernandes	1
SusanB.Davidson	ShirleyCohen	1
NorazwinBuang	MichaelJ.Hill	1
RiccoRakotomalala	Jean-HuguesChauchat	1
PhuChienNguyen	HiroshiMotoda	1
YanRuiHuang	MiaoWen	1
ShiweiTang	GuojieSong	1
VagelisHristidis	OscarValdivia	1
TakahiraYamaguchi	HidenaoAbe	4
JeffreyXuYu	ChengqiZhang	1
LucDeRaedt	AlbrechtZimmermann	1
YanchangZhao	JiaruiNi	1
WeiningQian	FengCao	1
FanYang0002	ChavdarBotev	1
ScottKlasky	BertramLud*scher	1
MiloradKrneta	JianhongWu	1
RanWolff	HillolKargupta	1
VladimirCherkassky	TaoXiong	1
RomanSchmidt	Kai-UweSattler	1
OlatzArbelaitz	JavierMuguerza	1
MingZhang	AiqiangGao	1
O.Rodr*guez	O.Garc*a	1
StefanSeltzsam	StefanKrompass	1
RobertGruber	MarkDaly	1
WeiWang0009	JianjunXu	1
FrancescoParisi	FilippoFurfaro	1
ManishBhide	LaurentMignet	1
TimothyRoscoe	JosephM.Hellerstein	1
ShixiaLiu	NanCao	1
SumitNegi	SreeramBalakrishnan	1
InderpalNarang	CalistoZuzarte	1
LuisGravano	EugeneAgichtein	1
NelsonF.F.Ebecken	CarlosAndr*R.Pinheiro	1
BrunoRoustant	BorisChidlovskii	1
WitoldAbramowicz	TomaszKaczmarek	1
RobertJ*schke	BernhardGanter	1
PaolaPodest*	BarbaraCatania	1
RunpingQi	RonnyLempel	1
SamuelMadden	EdmondLau	1
JunZhang	BolinDing	1
NagaK.Govindaraju	DineshManocha	3
TakashiWashio	KentaFukata	1
RaghuRamakrishnan	BoonThauLoo	1
DavidA.Lifka	ChristopherD.Jones	1
TranT.Hoai	SouravS.Bhowmick	1
PeterWackersreuther	Hans-PeterKriegel	1
J.ScottOlsson	DouglasW.Oard	1
ByronDom	AlexandrinPopescul	1
MoonJeungJoe	Gye-JeongKim	1
Wang-ChienLee	BaihuaZheng	3
NanJiang	AlokN.Choudhary	1
MichaelJ.Carey	DanielEngovatov	1
ZakiaFerdousi	AkiraMaeda	1
P.Anandan	HonestyC.Young	1
ManuelCalimlim	LawrenceGibbons	1
MarcMaier	DavidJensen	1
YongYu	JinWang	1
Jian-TaoSun	HuiZhao	1
YijianBai	HaixunWang	1
PeterTriantafillou	NikosNtarmos	3
PingWu	DivyakantAgrawal	1
LawrenceGibbons	JohannesGehrke	1
KameshMunagala	JunYang0001	2
ShanshanWang	GalitShmueli	1
WilliamI.Grosky	JigneshM.Patel	1
SoumenChakrabarti	AlekhAgarwal	2
LinLi	BinWang	1
Shinn-JangHo	Hung-MingChen	1
RichardKuntschke	AlfonsKemper	2
MarcBrette	BorisChidlovskii	1
HuipingCao	DavidW.Cheung	1
KevinChen-ChuanChang	JunghooCho	1
Zheng(Jessica)Zhao	LaksV.S.Lakshmanan	1
ElkeAchtert	DominikSchwald	1
W.BruceCroft	ChiragShah	1
ThomasNeumann	GuidoMoerkotte	1
SreeramBalakrishnan	SachindraJoshi	1
Yen-KuangChen	GregoryBuehrer	1
HiromiItohOzaku	AkinoriAbe	1
ThomasP.Albright	QinfengGuo	1
WeiyiMeng	ClementT.Yu	5
LingWu	GuojieSong	1
XianPingTao	JianLu	1
GiuseppeDiFatta	AntoninoFiannaca	1
SelcukAya	DavidA.Lifka	1
TheodoreDalamagas	PawelPlacek	1
KarlAberer	AliSalehi	1
SrinivasanParthasarathy	*mitV.*ataly*rek	1
JeffreyT.Kreulen	JamesRhodes	1
VipinKumar	Gy*rgyJ.Simon	1
TheodoreDalamagas	StefanosSouldatos	1
YanjiangYang	RobertH.Deng	1
DayouZhou	AlinDeutsch	1
ZhiyongHuang	ChristianS.Jensen	1
PatrickZiegler	ChristophSturm	3
RohitKumar	DavidM.Steier	1
NikolajTatti	AristidesGionis	1
ShuangWu	ChunyuYang	1
TrevorHastie	KennethWardChurch	1
YihaoZhang	WeiqiangLin	1
KenC.K.Lee	BaihuaZheng	3
ShubhaU.Nabar	KrishnaramKenthapadi	1
TonyFallon	JieChen	1
OdedShmueli	MukundRaghavachari	1
Kian-LeeTan	BengChinOoi	3
TimChurches	PeterChristen	1
YunyueZhu	GermanShegalov	1
VaniaBogorny	PauloMartinsEngel	1
ArnoSiebes	ArneKoopman	1
JudithLogan	JamesF.Terwilliger	1
XueminLin	FlipKorn	1
MirekRiedewald	JayavelShanmugasundaram	2
TianYu	JiahengLu	1
VinayakR.Borkar	TillWestmann	2
P.S.Sastry	NarenRamakrishnan	1
DouShen	BenyuZhang	1
FriedrichMayer-Lindenberg	ErikPasche	1
ToddJ.Green	SergeyMelnik	1
DuenHorngChau	ChristosFaloutsos	1
ShirleyCohen	BradBenton	1
M.NarasimhaMurty	ChiranjibBhattacharyya	1
NieYu	GuozhengXiao	1
Jian-TaoSun	DouShen	3
CyrusShahabi	AliKhodaei	1
ZacharyG.Ives	NicholasE.Taylor	1
GiorgioGhelli	ChristopherRe	1
JensTeubner	JanRittinger	2
BurcinBostan-Korpeoglu	AdnanYazici	1
HongyanLiu	DongXin	3
MingjieZhu	FeiXing	1
JoeXavier	BrandonBerg	1
PanayiotisTsaparas	AristidesGionis	1
MarianneWinslett	JeffreyM.Bradshaw	1
VickyNassis	J.WennyRahayu	1
Yo*lleS.Maarek	RonnyLempel	1
SangKyunCha	RajeevRastogi	1
KarlAberer	GustavoAlonso	1
RonnyLempel	JohnMcPherson	1
DuyguUcar	*mitV.*ataly*rek	1
InaM*ller-Gorman	ChristianB*hm	1
XiaoleiLi	HongCheng	1
Jean-RochMeurisse	Jean-LucHainaut	1
StephenRobertson	NickCraswell	1
NarenRamakrishnan	MalcolmPotts	1
YannisManolopoulos	AntonisSidiropoulos	1
ThomasSeidl	AndreaWenning	1
QiongLuo	DikLunLee	1
NingLiu	JunYan	3
FushengWang	FredAzar	1
FeifeiLi	AzerBestavros	1
SamuelMadden	AllenMiu	1
SalvatoreOrlando	FrancescoBonchi	1
VincenzoMinei	LucaDeRosa	1
PeiyaLiu	GeraldMadlmayr	1
SenthilPeriaswamy	MarcosSalganicoff	1
KarinaWolfram	AndreaPorzel	1
XiaoyuanWang	WeiWang0009	3
M.NarasimhaMurty	AsharafS	1
Marc-Andr*Mittermayer	GerhardKnolmayer	1
MironLivny	JeffreyF.Naughton	1
VasantHonavar	RobynR.Lutz	1
HonestyC.Young	C.Mohan	1
ValentinKuznetsov	LawrenceGibbons	1
SethHettich	MichaelJ.Pazzani	1
WenfeiFan	PhilipBohannon	1
WeiliWu	SamYuanSung	1
XingzhiSun	MariaE.Orlowska	1
PabitraMitra	BarnaSaha	1
EricBouillet	ArisAnagnostopoulos	1
PercyBernedo	LeGruenwald	1
Kai-UweSattler	ChristianLemke	1
ManLungYiu	KyriakosMouratidis	1
NathanSeeley	AndrzejUszok	1
VolkerMarkl	PeterJ.Haas	3
ZhaohuiWu	YanguZhang	1
TatjanaEitrich	BrunoLang	1
DominicMazzoni	BenjaminCichy	1
WynneHsu	GuimeiLiu	1
WeiWang0010	AndrewB.Nobel	1
LucianPopa0002	JosephM.Hellerstein	1
KyojiKawagoe	BattuguldurLkhagva	1
VijayGandhi	SucharitaGopal	1
YanlingLi	SenQin	1
XueLi	MariaE.Orlowska	1
RahulSingh	NaureenMoon	1
RobertoBattiti	AnuragGarg	1
TengjiaoWang	LingWu	1
PauloG*es	FernandoMour*o	1
StefanBrecheisen	AlexeyPryakhin	1
NitinGupta	KamalTiwari	1
ZhenjieZhang	AnthonyK.H.Tung	3
YunChi	BelleL.Tseng	1
JaewooKang	DongwonLee	1
HuyT.Vo	Cl*udioT.Silva	2
HaesunPark	ChrisH.Q.Ding	1
FarshadFotouhi	FarhadMostowfi	1
MariaCamilaNardiniBarioni	AgmaJ.M.Traina	1
MaximSchwarzkopf	ChristophHeinz	1
SergioGreco	AndreaTagarelli	2
PankajK.Agarwal	JunYang0001	1
RinaPanigrahy	AndrewTomkins	1
RonaldGreeley	BenjaminCichy	1
KatharinaProbst	AndrewE.Fano	1
ZimingZhuang	W.P.Weiss	1
ToralfKirsten	ErhardRahm	1
ShadiAlShehabi	NicolasCarrez	1
TimFinin	LalanaKagal	1
SergioGreco	MassimilianoRuffolo	1
PradeepTamma	AlanFekete	1
ZhangMing	WuWeimin	1
YufeiTao	YangDu	1
TiankaiTu	JulioC.L*pez	1
YinYang	DimitrisPapadias	1
RicardoA.Baeza-Yates	BerthierA.Ribeiro-Neto	1
EmanueleSantos	CarlosEduardoScheidegger	2
SpirosPapadimitriou	JimengSun	3
MaxWelling	KenichiKurihara	1
ZhangangLin	YueMa	1
XuehuaShen	DongXin	1
ZhuZhang	BalajiVaradarajan	1
VivekanandGopalkrishnan	KelvinSim	1
LeahE.Steinberg	AnnaM.Ritz	1
SasoDzeroski	AmandaClare	1
MuthuramakrishnanVenkitasubramaniam	AshwinMachanavajjhala	2
JunXu	JiaWang	1
ZuoquanLin	ZhangangLin	1
FrankNeven	DieterVandeCraen	1
CaijieZhang	AmrElAbbadi	1
MarcosSalganicoff	JinboBi	2
BinWu	BaiWang	1
SureshVenkatasubramanian	NickKoudas	1
VladimirCherkassky	RaviJanardan	1
ClaudineSantosBadue	BerthierA.Ribeiro-Neto	1
LaurentMignet	D.V.S.Ravikant	1
MingFan	HongjianFan	1
WalterA.Kosters	JeroenF.J.Laros	1
SubramanianArumugam	ChrisJermaine	1
IoanaStanoi	ChristianA.Lang	1
Ren*eJ.Miller	AlbertoO.Mendelzon	1
SatoshiOyama	KatsumiTanaka	3
RunpingQi	JohnMcPherson	1
KamalikaDas	HillolKargupta	1
PavelDmitriev	JuliaDeneva	1
DavidR.Musicant	Bee-ChungChen	1
HongyuGuo	HernaL.Viktor	2
XueminLin	XiaofangZhou	1
Hans-PeterKriegel	ArthurZimek	3
SalvatoreGaglio	RiccardoRizzo	1
DariaSorokina	ArtMunson	1
KouzouOhara	AkiraMogi	1
SitaramAsur	DuyguUcar	1
WilliamJ.Merline	LucasScharenbroich	1
JianhongZhou	AlokN.Choudhary	1
VitalyShmatikov	JustinBrickell	1
Shinn-YingHo	Hui-LingHuang	1
XiangyeXiao	QiongLuo	1
WeiZhang	NeilR.Smalheiser	1
WilliamL.Barth	BradBenton	1
NagendraSingh	AuroopR.Ganguly	1
PradeepTamma	PhilipA.Bernstein	1
TorstenSteinbach	SoujanyaVadapalli	1
RobynR.Lutz	JyotishmanPathak	1
JulioCesarSampaiodoPradoLeite	BrunoGonz*lez-Baixauli	1
XiaochunYang	GeYu	1
MelanieWeis	JanHegewald	1
Young-KooLee	Il-YeolSong	1
SangKyunCha	MeichunHsu	1
VasantHonavar	DimitrisMargaritis	1
YuguoLiao	LizhuZhou	1
YenelYildirim	JohnJannotti	2
IsseiSato	HayatoYamana	1
YanSong	MengWang	1
YenelYildirim	YanifAhmad	2
TimothyRoscoe	RaghuRamakrishnan	1
Kai-UweSattler	AndreasJob	1
SioIongAo	MichaelK.Ng	1
ManuelCalimlim	JohannesGehrke	1
NicholasGerner	AlanJ.Demers	1
ShubhaU.Nabar	RaviKumar	1
WalidG.Aref	MohamedY.Eltabakh	1
WeiWang	HaofengZhou	1
YitzhakMandelbaum	MaryF.Fern*ndez	1
FabianM*rchen	AlfredUltsch	1
MohammedJ.Zaki	LizhuangZhao	1
HonglinLi	AijuanDong	1
ChristopheG.Giraud-Carrier	BrentWenerstrom	1
VagelisHristidis	NickKoudas	1
PaulB.Kantor	BingBai	1
RosieJones	KristinaLisaKlinkner	1
FengShao	FanYang0002	1
RajeevMotwani	MarcusFontoura	1
YingjiuLi	XintaoWu	3
TahsinM.Kur*	SrinivasanParthasarathy	1
MasaruKitsuregawa	KulwadeeSomboonviwat	1
Woong-KeeLoh	Il-YeolSong	1
KelvinSim	GuimeiLiu	1
ThemisPalpanas	ChristianA.Lang	1
YiyuYao	LiqiangGeng	1
JoostN.Kok	JeroenF.J.Laros	1
JohnYen	DingZhou	1
JacobD.Furst	DanielaStanRaicu	1
EduardC.Dragut	ClementT.Yu	2
DavideMartinenghi	AlessandroCampi	2
SurajitChaudhuri	GerhardWeikum	2
ManuelMej*as	AntoniaM.ReinaQuintero	1
YuchunTang	YuanchenHe	1
JialieShen	BinCui	1
HuCao	BoXu	1
TomoharuIwata	TakeshiYamada	1
VictorS.Sheng	TilmannF.W.Bruckhaus	1
RudiBelotti	NadirWeibel	1
LinGuo	ChavdarBotev	1
TingLiu	Si-weiGao	1
VinodYegneswaran	Bee-ChungChen	2
PierreGan*arski	AlexandreBlansch*	1
HangLi	GuangFeng	1
KarinaWolfram	AlexanderHinneburg	1
TharamS.Dillon	FarookhKhadeerHussain	1
ElkeA.Rundensteiner	DavidC.Brown	1
Ching-ChiHsu	Baw-JhiuneLiu	1
LeventBolelli	C.LeeGiles	1
Seung-wonHwang	MinWang	1
YunboCao	ShenghuaBao	2
StephenWright	JeffreyF.Naughton	1
RalfRantzau	RakeshAgrawal	1
MarcosAntonioVazSalles	Jens-PeterDittrich	1
SivaGurumurthy	DipanjanChakraborty	1
YoungChulPark	GeumJiCha	1
MichaelWurst	MartinScholz	2
JillesVreeken	ArnoSiebes	2
Lee-FengChien	Ching-HsiangTsai	1
PeterKunath	FlorianVorberger	1
WeiyiMeng	FangLiu	1
WeihongWang	ShengZhang	1
SteveKelling	MirekRiedewald	1
JuliaDeneva	JimCordes	1
IoanaStanoi	GeorgeA.Mihaila	1
JavierMuguerza	IbaiGurrutxaga	1
Yiu-mingCheung	JoshuaZhexueHuang	1
PeterBuneman	AdrianeChapman	1
YingChen	AndrewRau-Chaplin	1
TorstenGrust	JensTeubner	2
NaveenAshish	DmitriV.Kalashnikov	1
ThomasPlagemann	EllenMunthe-Kaas	1
PaoloCiaccia	IlariaBartolini	1
CesarePautasso	AphroditeTsalgatidou	1
YingChen	D.Green	1
FoscaGiannotti	ClaudioLucchese	1
MuraliMani	MingLi	2
HengTaoShen	BengChinOoi	1
StefanoLonardi	ScottSirowy	1
JeffM.Phillips	AndrewMcGregor	1
KateSmith-Miles	CliftonPhua	1
MuraliMani	MingzhuWei	2
HaixunWang	DavidW.Cheung	1
ThomasG.Smith	DeborahS.Gross	1
WilliamY.Arms	MirekRiedewald	1
XuanyangXie	ShouhongWan	1
JianyongWang	GeorgeKarypis	1
ManuelCalimlim	JuliaDeneva	1
ZheweiJiang	FengYan	1
LukaszGolab	KumarGauravBijay	2
YunboCao	YongYu	2
YokoKamidoi	TomotakeNakamura	1
YumingOu	LongbingCao	1
JunYang0001	AdamSilberstein	4
PaeaLePendu	DejingDou	1
TovaMilo	NeoklisPolyzotis	1
NathanGood	DavidPennock	1
KeWang	HadyWirawanLauw	1
ZhangMing-Wei	WangBo	1
LucaCabibbo	IvanPanella	1
PeterVorburger	AbrahamBernstein	1
RobertoCelle	GiovannaGuerrini	1
Wen-YuanKu	Shinn-JangHo	1
ShoushenYang	MingLi	1
IadhOunis	CraigMacdonald	1
YuanYuanGuo	ManLeungWong	1
Hua-FuLi	Fang-FeiKuo	2
SudeeptBhatnagar	ElkeA.Rundensteiner	1
ValentinKuznetsov	DavidA.Lifka	1
JeffreyXuYu	GabrielPuiCheongFung	1
NawaazAhmed	FuchunPeng	1
Ji-RongWen	BoZhang	1
VibhutiS.Sengar	PrasanRoy	1
NicolaOnose	EmiranCurtmola	1
KlemensB*hm	JuttaA.M*lle	1
DongweiCao	DanielBoley	1
QiLi	JiepingYe	1
MingLi	DrewDitto	1
NoriakiKuwahara	AkinoriAbe	1
JingWang0007	DanJiang	1
DavideMartinenghi	DanieleBraga	2
NicolasCarrez	Jean-CharlesLamirel	1
Ming-SyanChen	Ken-HaoLiu	1
ThomasG.Smith	DavidR.Musicant	1
YitzhakMandelbaum	XuanZheng	1
NingZhang0002	M.Tamer*zsu	2
StratosPapadomanolakis	GerdHeber	1
StefanBrecheisen	FlorianVorberger	1
ChongHuang	CharlesX.Ling	1
TomokiWatanuma	TakenaoOhkawa	1
AnnettWania	AlexandreBlansch*	1
DavePearson	AndrewEisenberg	1
SuzanneM.Embury	BinlingJin	1
MoiraC.Norrie	CorsinDecurtins	1
SandrodaSilvaCamargo	LuisOt*vioAlvares	1
YannisTheodoridis	EvangelosDellis	1
TovaMilo	AnatEyal	1
MichaelJ.Franklin	ChungWu	1
MichaelPantazoglou	CesarePautasso	1
SaehoonKang	DongmanLee	1
VladislavShkapenyuk	KunGao	1
VijayGandhi	JamesM.Kang	1
OmarBoucelma	AlbertoBelussi	1
SimonLaws	AndrewEisenberg	1
VivekR.Narasayya	EricChu	1
Jos*IgnacioMart*n	Jes*sM.P*rez	1
MinosN.Garofalakis	DavidE.Gay	1
ZhanhuaiLi	JiangYun	1
Yiu-KaiNg	GeYu	1
RemaPadman	JamieCallan	1
JianYin	JianPei	1
StephenFisher	ShengGuo	1
JamesT.Kwok	Andr*sKocsor	1
RavishankarRamamurthy	GovindKabra	1
MyraSpiliopoulou	BrijM.Masand	1
PeterA.Boncz	K.SjoerdMullender	1
LaksV.S.Lakshmanan	H.V.Jagadish	1
JeremyRogers	AlanL.Rector	1
PascalFrossard	EricBouillet	1
JunZhang	JieWang	1
MeiLiu	JuhuaChen	1
SatoshiKouno	HideakiTakeda	1
RobertW.P.Luk	EdwardK.F.Dang	1
VibhutiS.Sengar	D.V.S.Ravikant	1
PeterMork	KenSamuel	1
MohamedFaridElhawary	CaseySmith	1
NikosMamoulis	KyriakosMouratidis	1
Yang-SaeMoon	Woong-KeeLoh	1
PatrickZiegler	AbrahamBernstein	2
WaiLam	Tak-LamWong	2
Zhi-HuaZhou	SongcanChen	1
PanagiotisReveliotis	MichaelJ.Carey	1
Wen-ChiHou	Chih-FangWang	1
YijianBai	HetalThakkar	1
AntonioPicariello	AngeloChianese	1
NayerM.Wanas	NadiaHegazy	1
GeorgeKollios	AzerBestavros	1
ZhengyuanZhu	SureshVenkatasubramanian	1
JohnGoh	DavidTaniar	1
GeorgeForman	EvanKirshenbaum	1
TimosK.Sellis	EleniG.Christodoulou	1
KristianTorp	KennethHoukj*r	1
ChristophHeinz	AlexanderZeiss	1
ShariqRizvi	EugeneWu0002	1
YongHu	KangXie	1
StefaniaLeone	MichaelH.B*hlen	1
ZaiqingNie	BoZhang	1
ManuelCalimlim	GregoryJ.Sharp	1
XiaLin	HyoilHan	1
ShyongK.Lam	GeorgeKarypis	1
TarasRafa	DwightE.Nelson	1
JunYuan	AnneHunt	1
YiyuYao	MaheshShrestha	1
YanWang	ChunguangZhou	1
SarunasGirdzijauskas	MirkoSteinle	1
NingZhang0002	AshrafAboulnaga	2
ElisaBertino	BasitShafiq	1
ZhiyongHuang	ZhenjieZhang	1
GuangWang	GregButler	1
QuanlingWei	HongYan	1
QileChen	Mian-YunChen	1
PingWu	AmrElAbbadi	1
SasoDzeroski	LeanderSchietgat	1
Wang-ChienLee	MinjiWu	1
Jia-YuPan	ChristianB*hm	1
PatrickC.H.Ma	KeithC.C.Chan	1
JianXu	AdaWai-CheeFu	2
PauloG*es	AdrianoM.Pereira	1
PaolaPodest*	OmarBoucelma	1
TonyFallon	HuidongJin	1
UpendraV.Chaudhari	OlivierVerscheure	1
NagaK.Govindaraju	JimGray	1
YingXing	Jeong-HyonHwang	1
ChristianS.Jensen	AlbrechtSchmidt0002	2
RobertJ.Calin-Jageman	HongYang	1
ToddJ.Green	AlanNash	1
MichaelR.Berthold	AlfonsoUrso	1
VolkerTresp	MingruiWu	1
VanessaP.Braganholo	CarlosA.Heuser	1
RanWolff	ArieLeizarowitz	1
KarstenM.Borgwardt	Hans-PeterKriegel	3
MoiraC.Norrie	MichaelGrossniklaus	1
LiyingSui	AlinDeutsch	1
BrijM.Masand	BamshadMobasher	1
XiangdongZhou	WeiWang0009	1
TimmEuler	MichaelWurst	1
JonM.Kleinberg	AjitSingh	1
Yi-FangWu	XinChen	1
Juan-ZiLi	CanLiu	1
TillWestmann	DanielEngovatov	1
JianChen	HuiXiong	1
XifengYan	ChaoLiu0001	1
SongLiu	BinYao	1
WeiminXiao	KaidiZhao	2
KannanRajkumar	BalakrishnanRamadoss	1
JianyongWang	JianhuaFeng	3
RanWolff	AssafSchuster	2
ShipengYu	Hans-PeterKriegel	1
YvonneMorrow	LongbingCao	1
ShoukeQin	AoyingZhou	1
JoanFeigenbaum	JianZhang0004	1
IoannisPitas	BenoitM.Macq	1
OlegRostanin	KatsumiKanasaki	1
MichelSimonet	AnaSimonet	1
TomoharuIwata	KazumiSaito	1
Pang-NingTan	JingGao	4
Yi-HongChu	Kun-TaChuang	1
SachinThatte	AnilMalkani	1
OliverPo	DivyakantAgrawal	1
LiGao	Huai-YuanYang	1
Juan-ZiLi	GangWu	1
SushilK.Prasad	ShamkantB.Navathe	1
SimonJ.Cox	ArumugamPaventhan	1
ZhanhuaiLi	WangYong	1
ZhaohuiPeng	JeffreyXuYu	1
YixinDiao	AdamJ.Storm	1
Maria-EstherVidal	LouiqaRaschid	3
MichailVlachos	EamonnJ.Keogh	2
SarvjeetSingh	RahulShah	1
JunchangJu	JamesM.Kang	1
SrinivasanParthasarathy	HuiYang	1
HuiruZheng	FranciscoAzuaje	1
NadavEiron	EugeneJ.Shekita	1
DanieleBraga	AlessandroRaffio	1
ShaileshJoshi	CurtisE.Dyreson	1
JohnGoh	Ee-PengLim	1
WalkerM.White	AlanJ.Demers	1
RaghuRamakrishnan	PrasadM.Deshpande	1
PeterJ.Haas	PaulBrown	1
JinxiangDong	GangChen	1
JinxiangDong	ChunChen	1
Jae-GilLee	Hyo-SangLim	1
IsabelleMarshall	GiorgioCorani	1
ShirleyCohen	ShengGuo	1
TingshaoZhu	DaleSchuurmans	2
WenxinLiang	HaruoYokota	1
HangLi	GuoyangShen	1
ShawnR.Jeffery	MinosN.Garofalakis	1
TorstenSteinbach	SourashisRoy	1
VinayakR.Borkar	SunilJigyasu	1
RiccardoMartoglia	EnricoRonchetti	2
ShubhaU.Nabar	AnishDasSarma	1
SudeeptBhatnagar	SamratGanguly	2
MuthiahChettiar	JayavelShanmugasundaram	1
ShashiShekhar	JunchangJu	1
OlatzArbelaitz	Jes*sM.P*rez	1
UllasNambiar	SubbaraoKambhampati	1
XiaoyanLi	W.BruceCroft	1
LarsSchmidt-Thieme	KarenH.L.Tso	1
JulianaFreire	Cl*udioT.Silva	2
SilkeEckstein	BrigitteMathiak	1
XinPei	NanDu	1
SongWang	DrewDitto	1
KunZhang	BillP.Buckles	1
ToonCalders	SzymonJaroszewicz	1
KatsumiTanaka	ChiTian	1
GregoryJ.Sharp	DanielRiley	1
YuchangGong	XiLi	1
RaghuRamakrishnan	KristenLeFevre	2
StefanosSouldatos	DimitriTheodoratos	1
WilliamM.Pottenger	MuratCanGaniz	1
GavinM.Bierman	ChristophKoch	1
WeijunZhong	JieWang	1
YimingMa	QiZhong	1
SanghoKim	MeteCelik	1
NathanSeeley	LarsE.Olson	1
SimonLaws	MarioAntonioletti	1
Wen-ChiHou	AdegokeOjewole	1
YingZhang	JianXu	1
YuelongJiang	AnthonyK.H.Tung	1
RobertoCelle	MatteoAlbertoSorrenti	1
HamidPirahesh	C.Mohan	1
JayavelShanmugasundaram	ChavdarBotev	2
KarlTuyls	GeertJanBex	1
TingshaoZhu	RussellGreiner	1
Sang-HeeLee	EamonnJ.Keogh	1
KoustuvDasgupta	GautamDas	1
PhilipS.Yu	JimengSun	2
NikosMamoulis	ManLungYiu	4
LingFeng	ElizabethChang	1
WalkerM.White	MingshengHong	1
ZujiaXu	KunZhang	1
KrishnaramKenthapadi	BhaskaraMarthi	1
SimonLaws	DavePearson	1
NielsNes	MarcinZukowski	1
Wang-ChienLee	JulianWinter	2
SudhanKanitkar	MooiChooChuah	1
YongluanZhou	FengYu	2
YoungH.Cho	JamesMoscola	1
UlrichWagner	EtzardStolte	1
WalidG.Aref	Chi-YinChow	1
JeffreyM.Bradshaw	AndrzejUszok	1
RohitKumar	MarkusG.Anderle	1
KhalilM.Ahmed	AlaaeldinM.Hafez	1
HadyWirawanLauw	Ee-PengLim	1
M.Tamer*zsu	LukaszGolab	2
VolkerMarkl	TamMinhTran	3
NingLiu	BenyuZhang	3
WeiWang0009	JunqiZhang	1
XinZhou	FushengWang	1
JunHong	JinPei	1
JamesJ.Lu	Hahn-MingLee	1
KwangJinPark	Ki-SikKong	2
H.V.Jagadish	AnthonyK.H.Tung	2
JuanTrujillo	EduardoFern*ndez-Medina	1
WataruSunayama	MasahikoYachida	1
EamonnJ.Keogh	ArisAnagnostopoulos	1
XingYi	ChangshuiZhang	1
SujeevanAseervatham	EmmanuelViennet	1
ObiL.Griffith	ByronJ.Gao	1
ShiyongLu	JingHua	1
JohnF.Roddick	CarlMooney	2
MaheshShrestha	LiqiangGeng	1
SergeAbiteboul	IoanaManolescu	1
WoohyunKim	SaehoonKang	1
YingFeng	AmrElAbbadi	1
YingqiXu	JianliangXu	1
Wei-kengLiao	JianweiLi	1
MichaelD.Morse	JigneshM.Patel	1
PeterOwotoki	ErikPasche	1
SharadMehrotra	RamaswamyHariharan	1
LawrenceH.Reeve	JonathanC.Yang	1
OlivierBodenreider	FranciscoAzuaje	1
TingshaoZhu	JiayuanHuang	2
PranayJain	EugeneAgichtein	1
UmeshwarDayal	KannanGovindarajan	1
RichCaruana	CaseySmith	1
NikolajTatti	HeikkiMannila	1
ManuelCalimlim	AndersRyd	1
NikosMamoulis	KitHungCheng	1
VanjaJosifovski	RajeevMotwani	1
PaoloPapotti	MauricioA.Hern*ndez	1
StanleyB.Zdonik	MitchCherniack	1
KevinWilkinson	KevinSmathers	1
JanParedaens	JanHidders	1
VasantHonavar	JyotishmanPathak	1
RanWolff	NoamPalatin	1
Shu-ChingChen	NaZhao	1
XiaohuaHu	XiaLin	1
Si-weiGao	KejunZhu	1
NagwaM.El-Makky	AlaaeldinM.Hafez	1
SougataMukherjea	AmitAnilNanavati	1
VictorMunt*s-Mulero	JosepAguilar-Saborit	1
MarkoKrema	AndrewE.Fano	1
QiangYang	JilinChen	1
WilliamY.Arms	ValentinKuznetsov	1
UmeshwarDayal	Mal*Castellanos	1
EamonnJ.Keogh	Dah-JyeLee	1
OlfaNasraoui	BrijM.Masand	1
Shian-ShyongTseng	Ching-YaoWang	1
XuanhuiWang	Hua-JunZeng	1
Yiu-KaiNg	LinLi	1
YingFeng	CaijieZhang	1
EvangelosDellis	BernhardSeeger	1
JulianaFreire	HuyT.Vo	2
R.BharatRao	JianmingLiang	1
Seung-CheonBaek	Gye-JeongKim	1
PeterTriantafillou	MatthiasBender	2
StephanBloehdorn	RobertoBasili	1
ShengMa	Chang-ShingPerng	1
KatsumiTanaka	HiroshiKori	1
GavinM.Bierman	BrianBeckman	1
PeterScheuermann	JeHyunCho	1
RafiAhmed	HongSu	1
WagnerMeiraJr.	PauloG*es	1
ShubhaU.Nabar	ParagAgrawal	1
YumaoLu	NawaazAhmed	1
Fran*oisFouss	AlainPirotte	1
LeoMark	GoviGovindarajan	1
JunjieWu	HuiXiong	1
MirekRiedewald	ArtMunson	1
InaM*ller-Gorman	ArthurZimek	1
ElkeAchtert	ArthurZimek	2
QuangHieuVu	BengChinOoi	2
RosaMeo	GiuseppePsaila	1
Lo*cRoyer	AlexanderKozlenkov	1
YihuaWu	FlipKorn	2
EfstratiosGallopoulos	DimitriosZeimpekis	1
VladimirBychkovsky	KevinChen	1
ZhongfeiZhang	AlbertoDelBimbo	1
XiaojunChen	JoshuaZhexueHuang	1
MiguelFerreira	DanielJ.Abadi	1
ThemisPalpanas	DimitrisPapadopoulos	1
BasilioSierra	AitzolAstigarraga	1
Sheau-DongLang	KienA.Hua	1
YueXu	EstherGe	1
MichaelJ.Franklin	JenniferWidom	1
MichaelReichert	D.V.S.Ravikant	1
IngoMierswa	FabianM*rchen	1
SusanMalaika	AndrewEisenberg	1
YuanchenHe	Yan-QingZhang	1
ZimingZhuang	JiaLi	1
ChristineM.O'Keefe	ChrisKelman	1
RaghuRamakrishnan	HongfeiGuo	1
S*ndorH*man	PeterA.Boncz	1
RobinD.Burke	BamshadMobasher	2
NeleDexters	DirkVanGucht	1
ZhangMing-Wei	WeiWei-Jie	1
XiaoboZhou	StephenT.C.Wong	1
SalvatoreGaglio	AntoninoFiannaca	1